的	kewt
一	jdee
是	diwj
了	iexi
不	nrko
我	wnqo
有	jgka
在	vpke
人	amso
他	lfsx
这	ejyp
里	idge
来	izlo
个	gjsi
时	diwj
事	diji
上	dlae
没	mvdt
大	kfko
们	mwsu
你	odst
到	ksms
说	dnpi
也	jtxa
着	ejig
就	ugyk
见	ucgt
道	ksip
子	vixe
中	ehgi
那	ofzx
为	wiio
出	suxi
么	meto
可	rjjf
要	jbjc
小	hbdo
行	hxeh
下	hfjo
去	yrev
得	keew
以	jdvs
快	rroz
看	rklg
她	lfcx
如	aucf
然	akto
过	gnjp
自	viwe
和	fjqf
会	fash
好	fscx
之	eipo
对	kavj
天	lcho
能	oovt
而	ziki
还	fpkp
地	kdex
都	kvjx
都	kyjx
后	fyef
心	hapo
生	doqe
家	ufok
起	ydez
多	kntt
用	jsti
想	hvnp
只	eifr
于	jrhi
面	mcke
点	kcao
样	jvni
三	tkhe
所	tnee
四	tige
头	lvoo
头	lyoo
又	jgvo
作	vnsq
手	dyli
华	fesj
方	xlyu
些	htah
无	wuha
现	hchg
年	ocqi
国	gnfh
知	eiqf
文	wmyo
成	soko
前	ycia
把	nflx
老	isjt
几	udta
己	udza
发	xjcv
发	xfcv
身	dmwu
话	fepq
法	xjde
法	xfde
两	ivjo
笑	hbqq
开	rphi
意	jdyp
学	heox
已	jdza
本	nwje
很	fmez
经	uxbv
当	klfz
但	kksw
分	xmrc
儿	zita
太	lzko
同	lhge
声	doex
十	diji
回	faff
情	yxoh
实	dioo
才	cpju
此	ciat
从	chss
种	ehqg
动	khhc
间	ucuw
定	kxoj
明	mxwa
力	idcu
气	ydqa
其	ydjr
眼	jcgz
走	vyea
进	uahp
女	ouce
二	zihe
因	jafk
与	jrme
给	gibs
真	emjr
问	wmuf
数	duiq
正	eoje
将	uvyt
理	idhg
向	hvwf
最	vawj
神	dmpg
先	hcqt
高	gsyf
外	wptf
者	ejjw
打	kflj
应	jxyo
算	twqg
全	ywsh
信	hasy
便	ncsj
等	koqe
日	aiwe
相	hvng
再	vpje
听	lxfe
主	euye
被	nvpc
被	nipc
白	nzwe
并	nxih
系	hdtd
却	yeex
口	ryfe
光	gdfk
西	hdje
别	ntfs
边	nccp
使	disj
机	udnt
少	dsdu
候	fysz
怎	vmqp
处	sutf
呢	oefz
表	nbht
住	eusy
体	ldsj
门	mwua
关	gwih
由	jgge
第	kdqz
次	ciyt
让	alpa
名	mxtf
月	jeae
果	gngo
比	ndmt
象	hvtg
做	vnsj
结	utbe
性	hxoq
感	gkkp
新	haye
位	wisy
长	slqo
常	slff
色	tjtx
张	elzq
长	elqo
风	xotr
它	lfot
接	utly
觉	ueog
更	gojo
何	fjsj
军	uqpm
死	tikt
东	khmo
战	ekam
脸	icas
字	viox
谁	daps
水	dado
平	pxli
件	ucsq
许	hrpq
像	hvst
通	lhvp
书	dubo
部	nryx
计	udpj
王	wlhe
放	xlyq
吧	nffx
直	eijg
连	icmp
完	wkoh
量	ivwg
难	okvs
统	lhby
叫	ubfx
变	ncyv
工	ghje
空	rhoj
清	yxdh
入	auro
亲	yayn
五	wuje
公	ghrv
立	idye
息	hdwp
内	oigo
据	urlz
且	ytge
写	htpm
语	jrpj
原	jwkw
山	dkgi
望	wlyh
加	ufcf
教	ubjq
轻	yxmv
程	soqf
思	tigp
度	kryv
特	leqe
花	feus
吃	sifq
则	vjgs
或	fnmf
命	mxsf
合	fjsf
吗	mffb
马	mfbe
今	uasp
路	irft
提	ldlw
化	fest
海	fpdq
目	mrge
解	uttc
必	ndpo
带	kzjg
民	maza
士	diee
爱	zprk
非	xiaa
图	lrft
虽	tafg
该	gppy
至	eime
世	dija
言	jcyh
美	mvik
美	miik
安	zkoc
活	fndq
龙	ihko
式	dimj
似	tisv
物	wuqt
总	vhip
任	amsq
形	hxhe
远	jwhp
受	dyrv
跟	gmfz
乎	furi
金	uave
义	jdio
论	iqps
强	yvzf
代	kzsm
微	wieg
满	mkdu
题	ldwk
坐	vnse
钱	ycvh
若	anuk
车	sjmi
半	nkii
飞	xico
反	xkev
指	eilt
啊	zffx
报	nslx
服	xuax
找	eslm
类	iiik
黑	figo
界	utgs
转	ewmh
李	idnx
制	eiqs
即	udzx
记	udpz
师	didj
往	wley
怕	pfow
刚	glgs
夫	xuho
传	swsh
各	gjtf
容	ahor
及	udto
管	gwqo
步	nrad
红	fhbj
城	soek
音	jayw
火	fnis
干	gkhi
利	idqs
句	urtf
万	wkmu
姐	utcg
九	ugta
魔	mnyw
模	mnnu
条	lbtn
场	slec
流	igdy
重	ehqe
识	dipf
青	yxha
切	ytmc
百	nzkw
云	jqhv
早	vswj
每	mvqb
每	miqb
求	ygjo
北	nvat
北	niat
八	nfro
办	nkco
近	uaep
设	djpt
房	xlpy
随	taxk
集	udsn
喜	hdef
失	diqo
务	wutc
离	idyg
孩	fpxy
告	gsqf
兵	nxwr
术	duno
电	kcga
决	ueyz
影	jxwe
拿	ofsl
认	amps
交	ubyr
极	udnt
器	ydfk
站	ekya
竟	uxyt
请	yxph
林	iano
始	dicv
友	jgkv
灵	ixzi
精	uxih
够	gytt
刻	rjys
单	kkig
落	inud
越	jeem
拉	ifly
深	dmdp
存	cqkx
父	xurr
队	kaxs
七	ydma
示	dihd
冷	ioys
元	jwht
根	gmnz
哪	offz
惊	uxoy
哥	gjjj
杀	dfrn
功	ghjc
斯	tije
紧	uasb
消	hbdf
收	dyxq
兴	hxor
静	uxht
保	nssf
般	nket
整	eojj
周	eyte
母	mrbo
石	dikf
怪	grov
送	thip
星	hxwq
击	udhi
阵	emxm
爷	jtrx
型	hxhe
苦	ruuj
基	udje
男	okgc
族	vuyq
忙	mloy
未	wiho
弟	kdiz
六	igyr
复	xuqw
衣	jdyo
确	yekt
敢	gkzq
片	pcwa
故	gujq
究	ugot
南	okjg
答	kfqs
取	yrjv
妈	mfcb
奇	ydke
谈	lkpi
客	rjot
备	nvtg
备	nitg
绝	uebt
期	ydja
网	wlgr
足	vufa
英	jxug
底	kdyt
线	hcbh
慢	mkow
千	ycqi
格	gjnt
易	jdwt
包	nstz
夜	jtys
热	ajlo
树	dunv
显	hcws
构	gynt
照	eswo
员	jwfg
突	lrok
终	ehbt
业	jtse
块	rrez
运	jqhp
令	ixsp
估	gusj
暗	zkwy
双	ddvv
众	ehss
准	eqys
古	gujf
引	jazi
态	lzkp
尽	uazo
布	nrkg
修	hgst
留	igtg
武	wuha
血	hewe
晚	wkwt
创	sdss
断	kwie
官	gwog
德	keej
响	hvfw
错	cnvj
建	uczv
达	kfkp
低	kdst
欢	fwvt
诗	dipe
尔	zitd
罗	ingt
标	nbnh
改	gpzq
需	hrlk
领	ixsk
破	pnkc
玉	jrho
产	skyu
阳	jvxw
级	udbt
序	hryv
组	vubg
急	udtp
黄	fdjg
技	udlj
院	jwxo
脚	ubae
章	elyj
愿	jwkp
木	mrno
忽	futp
段	kwwt
帮	nlhg
嘴	vafa
号	fsfm
除	suxs
久	ugto
视	dipg
乐	ieto
伤	dlsq
念	ocsp
细	hdbg
造	vsqp
团	lwfj
重	shqe
冲	shyg
阿	zfxe
值	eisj
具	urgr
节	utux
陈	smxm
跑	psft
乱	iwqa
词	cipz
简	ucqu
京	uxyf
势	dilc
依	jdsy
持	sile
展	ekzj
科	rjqo
朋	poaa
装	edyy
渐	ucdm
较	ubmy
艺	jdua
娘	ovcp
异	jdzk
另	ixfc
台	lzvf
品	paff
规	gahg
兰	ikih
读	krpj
市	diyg
须	hrek
玩	wkhh
克	rjjf
屋	wuzm
观	gwvg
速	tujp
社	djpe
哈	fffs
围	wifh
画	feeg
穿	swom
况	rdyf
倒	kssm
罢	nfge
研	jckh
约	jebt
换	fwlt
注	eudy
呀	jffm
饭	xkte
层	cozh
害	fpoh
支	eijv
差	sfij
户	fupu
睛	uxgh
索	tnjb
政	eojq
雷	iilg
摇	jblr
待	kzee
假	ufsz
希	hdrk
丝	tibe
宝	nsoh
首	dyiw
称	soqt
楚	sunx
联	icji
攻	ghjq
船	swet
香	hvqw
初	supc
秋	ygqi
雪	helz
诉	tupe
斗	kvoj
斗	kyoj
库	ruym
病	nxyj
选	hwqp
您	oasp
旁	plyy
佛	xnsz
既	udzm
丽	ideg
赵	eser
酒	ugdj
背	nvaa
背	niaa
举	uroh
痛	lhyv
争	eotz
杨	jvnc
叶	jtfj
密	mdog
散	tkjq
群	yqzi
戏	hdvm
讲	uvph
司	tizf
证	eopj
汉	fkdv
雨	jrjo
志	eiep
参	ckve
旧	ugiw
校	hbny
皇	fdwh
派	pzde
赶	gkeh
停	lxsy
喝	fjfw
楼	iyni
议	jdpi
呼	fufr
试	dipm
护	fulp
推	lals
境	uxey
环	fwhk
刘	igys
脑	osay
资	viyg
亚	jfje
居	urzj
妹	mvch
妹	mich
亮	ivyt
调	lbpt
睡	dagq
肯	rmaa
局	urza
梦	mont
编	ncbp
掉	kbla
置	eigj
甚	dmjr
例	idsk
印	jatx
疑	jdtv
买	mzao
属	duzw
姑	gucj
恐	rhjp
敌	kdqq
江	uvdj
概	gpnz
招	eslc
查	sfnw
共	ghjr
威	wike
跳	lbfr
续	hrbj
兄	hsft
鬼	gawv
谢	htpw
角	ubtt
咱	vkfw
淡	kkdi
洋	jvdi
素	tuhb
专	ewho
刊	rkhs
顾	gukk
永	jspo
游	jgdy
顺	dqwk
控	rhlo
胡	fuja
状	edyk
致	eimq
区	yrmr
止	eiae
仙	hcsg
帝	kdyg
刀	kscu
商	dlyg
软	awmt
述	dunp
严	jcju
络	inbt
礼	idpa
考	rsjm
习	hdve
顿	kqmk
冰	nxyd
左	vnkj
余	jrsh
料	ibio
否	xykf
效	hbyq
堂	llfe
史	digo
输	dums
忘	wlyp
短	kwqe
燕	jcjf
历	idkc
味	wifh
仿	xlsy
烟	jcif
巴	nfxa
靠	rsqa
顶	kxjk
杂	vftn
采	cprn
维	wibs
岁	tagt
独	krtg
皮	pdcv
怀	frok
君	uqzf
朝	ssja
页	jtkg
仅	uasv
圣	dove
笔	ndqq
排	pzla
操	cslf
钟	ehvg
景	uxwy
土	lree
妇	xucz
列	itks
凤	xotv
巨	urmz
充	shyt
闪	dkus
广	gdyu
验	jcbs
激	uddw
费	xizg
铁	ltvq
闹	osuy
曾	coiw
权	ywnv
坏	frek
齐	ydyw
板	nkne
质	eiej
继	udbi
莫	mnuw
剧	urzs
耳	zije
翻	xkrv
忍	amcp
压	jfke
源	jwdk
恶	zjjp
治	eidv
按	zklo
伙	fnsi
球	yghj
馆	gwto
春	sqhw
苏	tuuc
默	mngk
抱	nslt
配	pvjz
配	pijz
府	xuys
射	djwj
隐	jaxt
退	lazp
河	fjde
卷	uwib
课	rjpg
毛	msqa
右	jgkf
狂	rdth
卫	wixe
烈	itko
际	udxh
奶	ozcc
略	ijgt
某	myjn
仍	aosc
端	kwyg
价	ufss
守	dyoj
封	xoej
划	fems
枪	yvns
孙	tqxd
胜	doaq
助	eugc
吴	wufh
缓	fwbr
卖	mzjo
唐	llyz
负	xutg
域	jrem
适	diqp
福	xupe
窗	sdow
弄	ohhk
导	kszj
梅	mvnq
梅	minq
米	mdio
哭	rufk
免	mctg
讨	lspj
增	voei
蓝	ikus
波	nndc
怒	orcp
掌	elfl
超	ssec
限	hcxz
遇	jrgp
码	mfkb
秀	hgqc
珠	euhq
贵	gagg
松	thnr
室	diom
虎	fuat
兽	dyie
歌	gjjt
纸	eibt
草	csuw
练	icbm
茶	sfus
叹	lkfv
施	diyq
纪	udbz
含	fksf
沙	dfdd
供	ghsj
呵	fjfe
桌	enan
剑	ucss
测	cjdg
街	utee
爸	nfrx
肉	aygs
灯	koij
刺	cijs
座	vnys
优	jgsk
率	iuyb
曲	yrge
束	dujo
抗	rlly
醒	hxjw
闻	wmuj
责	vjhg
舞	wuqt
版	nkwe
凡	xkto
虚	hras
防	xlxy
追	eawp
银	javz
床	sdyn
唱	slfw
归	gadz
泪	iidg
吸	hdft
露	irlf
译	jdpv
范	xkud
温	wmdw
挥	falp
救	ugjq
检	ucns
替	ldhw
祖	vupg
份	xmsr
麻	mfyn
眉	mvxg
眉	mixg
阴	jaxa
描	mblu
毕	ndmj
幸	hxei
良	ivpo
互	fume
伸	dmsg
雅	jfms
预	jrvk
盘	pkeg
秦	yahq
园	jwfh
革	gjjg
柔	ayvn
险	hcxs
股	guat
析	hdne
禁	uanh
阶	utxs
逃	lsrp
猛	motx
骑	ydbk
征	eoej
州	eyii
灭	mtei
担	kklw
演	jcdo
医	jdmq
警	uxuy
乡	hvbu
副	xues
啦	iffl
野	jtgv
承	soxo
拍	pzlw
秘	mdqp
伯	nnsw
喊	fkfk
项	hvjk
骂	mffb
养	jviw
寒	fkoo
婚	fqct
恨	fmoz
混	fqdw
架	ufcn
呆	kzfn
宇	jroh
丁	kxji
懂	khou
败	nzgq
普	priw
甲	ufgi
协	htjc
晓	hbwm
迷	mdip
善	dkif
墙	yvej
亦	jdyo
移	jdqt
凌	ixye
曼	mkwg
绿	iubz
执	eilt
烦	xkik
抓	eele
献	hcjk
察	sfot
宫	ghof
智	eiqw
投	lvlt
投	lylt
硬	jxkj
田	lcge
闲	hcun
厉	idkm
趣	yrej
介	utsw
陆	irxh
瑞	aahg
宣	hwoe
牛	ogqi
亡	wlya
借	utsj
释	dirv
叔	duav
抬	lzlv
摆	nzlg
熟	duyo
弱	anzz
卡	rfao
偷	lvss
偷	lyss
误	wupf
脱	lnai
寻	hqzj
宗	vhoh
案	zkon
富	xuoe
握	wnlz
紫	viab
罪	vaga
悲	nvap
悲	niap
评	pxpl
抽	sylg
敬	uxuq
店	kcya
湖	fudj
药	jbub
载	vpjm
徐	hres
付	xusj
朱	euqo
材	cpnj
摸	mnlu
扬	jvlc
尚	dlfg
狗	gytt
圆	jwff
琴	yahs
仁	amsh
峰	xogt
震	emlk
鼓	guej
魂	fqhw
姓	hxcq
坚	ucse
食	disp
骨	guga
午	wuqi
省	dodg
糊	fuij
毫	fsyq
欲	jrrt
透	lvqp
透	lyqp
探	lklp
惜	hdoj
鲁	irtw
托	lnlq
洞	khdg
临	iasq
营	jxuf
缺	yeqz
芳	xluy
牙	jfmu
绍	dsbc
虑	iuap
雄	hsks
盖	gpig
柳	ignt
辑	udmf
择	vjlv
洗	hddq
凭	pxst
录	irzd
婆	pndc
孔	rhxa
迎	jxtp
升	doqi
勇	jsvc
村	cqnj
巧	ybjm
迅	hqzp
尊	vqij
偏	pcsp
菜	cpur
套	lskj
党	klff
妙	mbcd
烧	dsim
萧	hbuz
藏	cluk
横	fonj
避	ndzp
挂	gele
批	pdlm
函	fkxx
职	eijf
灰	faki
拥	jslt
闭	nduj
育	jrya
胸	hsat
浪	ildp
拜	nzlh
怜	icos
尤	jgko
欧	zymt
休	hgsn
狠	fmtz
腿	laaz
哼	fofy
辈	nvam
辈	niam
纷	xmbr
牌	pzww
占	ekaf
妖	jbcq
策	cjqj
弹	lkzi
羽	jrvv
危	witb
袋	kzsy
获	fnut
符	xuqs
夏	hfkt
伟	wish
彩	cpre
诸	eupj
荣	ahun
幽	jggb
劳	isuc
丈	elko
鲜	hcti
训	hqpw
键	ucvz
狼	iltp
油	jgdg
稍	dsqf
恩	zmgp
嗯	zmfg
博	nnjj
庆	yxyk
奋	xmkg
碎	taky
固	gufj
遍	ncpp
班	nkhi
碰	poki
颜	jcyk
济	uddy
附	xuxs
舍	djsh
殿	kczt
赞	vkqg
圈	ywfi
肩	ucpa
宁	oxoj
鱼	jrtg
农	ohpo
尖	ucdk
登	kove
唯	wifs
轮	iqms
厅	lxkj
缘	jwbb
炼	icim
补	nrpf
纳	ofbg
典	kcgr
困	rqfn
佩	pvst
佩	pist
庄	edye
毒	krhb
蒙	mouh
娜	ofcz
迹	udyp
聚	urjw
杯	nvnk
杯	nink
织	eibf
厚	fykw
飘	pbjt
吹	saft
吓	hffj
嫂	tscw
宽	rwou
曰	jewe
挑	lblr
折	ejle
享	hvyf
均	uqet
丹	kkte
凉	ivyy
丰	xohi
访	xlpy
腰	jbaj
扑	prlf
冒	msgg
隔	gjxe
躲	knwt
竹	euqq
宋	thon
慧	fahp
淑	duda
嘿	fifg
昨	vnwq
插	sflq
席	hdyg
惯	gwob
翠	cavy
杰	utno
降	uvxt
委	wiqc
徒	lree
陪	pvxy
陪	pixy
积	udqf
判	pkis
拳	ywil
舒	dusv
映	jxwg
残	ckkh
莲	icum
剩	doqs
律	iuez
壁	ndze
堆	kaes
朵	kntn
尼	odzt
迟	sizp
缩	tnbo
著	euuj
幻	fwba
抵	kdlt
距	urfm
触	sutg
镜	uxvy
悄	ybof
诚	sopk
瞧	ybgs
庭	lxyq
私	tiqv
汗	fkdh
纯	sqbm
针	emvj
炮	psit
抢	yvls
递	kdip
询	hqpt
惨	ckov
括	rnlq
闷	mwup
幕	mrug
鼻	ndwg
减	ucyk
猜	cpth
玄	hwyb
扫	tslz
镇	emvj
丢	kgqv
犹	jgtk
铺	prvj
劲	uavc
谓	wipg
径	uxev
赛	tpog
末	mnho
胖	plai
妻	ydmc
穷	ysoc
弃	ydyk
忠	ehgp
财	cpgj
浮	xudr
忆	jdoa
胆	kkaw
彼	ndec
奔	nwkj
遗	jdgp
疯	xoyt
扩	rnly
孤	guxe
皱	eytc
稳	wmqt
累	iigb
晨	smwk
辛	hayj
宜	jdog
爆	nsiw
梁	ivdn
益	jdig
乃	ozcu
傲	zssh
凝	oxyt
犯	xktb
炸	efiq
吐	lrfe
净	uxyt
锋	xovt
瞬	dqgr
荡	klud
咬	jbfy
箭	ucqi
监	ucsg
洛	indt
挺	lxlq
逐	eukp
皆	utmw
躺	llwf
赏	dlfg
俗	tusr
翼	jdvg
愤	xmoj
劝	ywvc
旅	iuyq
赤	siew
旗	ydyq
贝	nvgs
贝	nigs
厂	slku
岛	kstg
鸣	mxft
迫	pnwp
昏	fqtw
番	xkrg
塔	lfeu
逼	ndep
授	dylr
尘	smde
阻	vuxg
欣	haet
尸	dizu
康	rlyz
舰	uceg
椅	jdnk
伊	jdsz
森	tmnn
鸟	obte
娇	ubcq
氏	dita
寂	udoa
粉	xmir
汽	yddq
鸡	udvt
吉	udef
芒	mluy
匆	chto
臣	smja
货	fnsg
鸿	fhdt
拟	odlv
臂	ndza
途	lrsp
慰	wizp
晶	uxww
蛋	kkxg
猫	mstu
颗	rjgk
陷	hcxt
菲	xiua
壮	edye
芬	xmur
努	orcc
奥	zswk
票	pbjh
敏	maqq
延	jcwv
仰	jvst
吟	jafs
恋	icyp
县	hcgv
杜	krne
滚	gqdy
忧	jgok
旋	hwyq
暂	vkmw
恢	faok
振	emlk
粗	cuig
零	ixls
挡	kllf
毁	fawt
伴	nksi
轰	fhmv
戴	kzjg
奈	ozkh
矩	urqm
盛	dokg
漫	mkdw
撞	edly
偶	zysg
嘛	mffy
颇	pnck
惑	fnmp
慕	mruf
伦	iqss
擦	cflo
厌	jckk
伏	xusk
枝	einj
慌	fdou
废	xiyc
沈	dmdp
挤	udly
吾	wujf
启	ydpf
侧	cjsg
泰	lzhd
纵	vhbs
寄	udok
订	kxpj
逻	ingp
岂	ydgz
摘	eply
辞	ciqy
塞	tpoe
祥	hvpi
尾	wizq
洁	utde
唤	fwft
暴	nswj
愈	jrsp
摩	mnyl
孟	moxg
损	tqlf
韩	fkjh
腾	loai
怨	jwtp
愁	syqp
础	sukx
洲	eydi
串	swgi
傻	dfsw
豪	fsyk
健	ucsz
苍	clus
雾	wult
拼	pali
哀	zpyf
袭	hdky
抖	kvlo
抖	kylo
磨	mnyk
睁	eogt
颤	skyk
匹	pdmt
频	paak
仇	syst
乌	wute
贴	ltga
聊	ibjt
储	susp
旦	kkwe
肚	krae
逸	jdtp
俩	ifsj
御	jreq
扎	efla
傅	xusj
唇	sqkf
夹	uflo
珍	emhs
荒	fduy
谷	gurf
绕	asbm
裂	itky
岸	zkgk
潮	ssdj
涌	shdv
墨	mnge
搬	nkle
漂	pbdj
搜	tylw
乘	soqa
帐	elgq
耐	ozkj
幅	xuge
爬	pfex
艾	zpur
夺	knkj
尝	slfh
掩	jclk
貌	msrw
陶	lsxt
羞	hgix
郎	ilpx
尺	sizo
桥	ybnq
哦	znfq
佳	ufse
姨	jdcm
戒	utmk
扭	oglx
冥	mxpw
搞	gsly
盟	mowg
挣	eolt
拾	dils
鞋	htje
滑	fedg
媒	mvcj
媒	micj
碗	wkko
详	hvpi
扯	sjla
稿	gsqy
枫	xont
诺	onpu
川	swwi
锁	tnvf
莉	iduq
浓	ohdp
恰	yfos
童	lhyg
狱	jrtp
聪	chji
奴	orcv
骗	pcbp
姊	vict
沿	jcdt
矣	jdvq
倍	nvsy
倍	nisy
醉	vajy
甫	xujo
拖	lnlq
岳	jewg
殊	dukq
核	fjny
扶	xulh
烂	ikii
赖	izjt
彻	sjem
浑	fqdp
冯	xoyb
遭	vsjp
痕	fmyz
屈	yrzx
仗	elsk
跃	jefq
邪	htmx
凶	hsrx
巡	hqbp
兼	ucio
晋	uajw
莱	izul
仲	ehsg
炎	jcii
焰	jcit
涂	lrds
泥	oddz
瞪	kogv
弯	wkyz
嘻	hdfe
荷	fjus
悟	wuoj
潜	ycdh
寿	dyhj
坡	pnec
晃	fdwf
悉	hdrp
季	udqx
绪	hrbj
链	icvm
蛇	djgo
埋	mzeg
垂	saqe
冬	khto
恭	ghjf
疼	loyt
郑	eoix
吞	lqhf
亭	lxyj
乔	ybqw
瘦	dyyw
踪	vhfo
朗	ilpa
箱	hvqn
悠	jgsp
斜	htso
倾	yxsm
祝	eupf
荪	tqux
仪	jdsi
盗	ksyg
羊	jvii
嫁	ufco
讶	jfpm
池	sidx
泛	xkdr
欺	ydjt
什	dmsj
伍	wusj
溜	igdt
贼	vigm
吼	fyfx
懒	ikoj
浅	ycdh
脆	caat
亏	raha
勉	mctc
萨	tfux
惠	fajp
韵	jqyt
嗯	#fg
敲	ybya
虫	shgo
玛	mfhb
悔	faoq
庞	plyk
坦	lkew
恼	osoy
浩	fsdq
拔	nflk
阁	gjut
凯	rpgt
辆	ivmj
丧	tljo
妮	odcz
碧	ndhk
搭	kflu
冠	gwph
筑	euqj
愣	ioog
泉	ywwd
融	aheg
罩	esga
郁	jrkx
讯	hqpz
繁	xkqb
仆	prsf
盾	kqej
洪	fhdj
袍	pspt
婉	wkco
挨	zplv
阔	rnud
俊	uqsv
茫	mlud
屏	pxzi
纹	wmby
凑	cyyh
辉	fafp
饰	ditq
舅	ugwg
甜	lcqj
循	hqee
址	eiea
滴	kddy
钻	vwva
侵	yasz
焦	ubso
拦	ikli
款	rwet
暖	owwr
惧	urog
遥	jbrp
丫	jfii
播	nnlr
甘	gkje
障	elxy
璃	idhy
额	zjok
肃	tuzo
卿	yxtz
汇	fadm
艳	jcht
奉	xohh
返	xkep
拒	urlm
辩	ncyp
隆	ihxt
叠	ktvg
惹	ajup
邻	iasx
销	hbvf
唉	zpfv
爽	ddkr
涉	djda
劫	utec
霞	hflz
咒	eyft
缠	skby
帽	msgg
帅	drdg
耀	jbfv
廷	lxqv
侍	dise
柱	euny
牧	mrqq
添	lcdh
脉	mzap
捉	enlf
牵	yckq
铜	lhvg
袖	hgpg
牢	isoq
驱	yrbm
堪	rkej
忌	udzp
爹	ktrt
倘	llsf
盯	kxgj
膀	nlay
截	utjs
牲	doqq
迁	ycqp
饿	zjtq
央	jvgo
餐	ckas
措	cnlj
企	ydsa
笼	ihqk
促	cusf
喷	pwfj
鹏	poat
矮	zpqq
霸	nflj
割	gjos
衡	foet
召	escf
姚	jbcr
润	aqdu
扰	aslk
辰	smkh
赌	krgj
丛	chse
扇	dkpv
庙	mbyg
郭	gnyx
豫	jrvt
缝	xobt
瓦	wfmo
哲	ejlf
董	khuq
晕	jqwm
港	gldj
锐	aavi
俄	zjsq
吵	ssfd
钧	uqvt
渡	krdy
竞	uxyf
扔	aolc
臭	sywk
耗	fshq
崇	shgo
桃	lsnr
寸	cqjo
邦	nlhx
琳	iahn
吕	iuff
赐	cigw
粮	ivip
舌	djqf
姿	viyc
抚	xulh
愧	raow
脖	nnaj
迪	kdgp
幼	jgbc
染	akdn
啸	hbfz
吻	wmft
予	jrvi
慈	ciip
玻	nnhc
佣	jsst
薄	nnud
抹	mnlh
嚷	alfy
培	pvey
培	piey
稀	hdqr
桂	gane
玲	ixhs
允	jqvt
趁	smes
糟	vsij
督	krag
猪	eutj
乙	jdaa
耶	jtjx
籍	udqh
悦	jeoi
勒	iejc
津	uadz
痴	siyq
侯	fysz
覆	xuje
屁	pdzm
踏	lffd
媚	mvcx
媚	micx
跪	gaft
井	uxhi
熊	hsvo
抛	pslt
催	casg
奸	ucch
扮	nklr
贤	hcsg
嫌	hcci
衫	dkpe
乏	xjro
乏	xfro
斩	ekme
咐	xufs
瓜	geeo
援	jwlr
哎	zpfu
酸	twjv
夸	rekh
肥	xiax
蒂	kduy
燃	akit
嘉	ufec
怖	nrok
牺	hdqj
欠	ycts
裁	cpjy
爵	uerz
鹰	jxyt
掏	lslt
捕	nrlj
钢	glvg
丑	syxe
卧	wnjf
汤	lldc
湿	didw
悬	hwgp
柜	ganm
疲	pdyc
厨	suke
辱	aukj
贫	parg
捧	polh
渊	jwdu
窝	wnof
桑	tlvn
乖	grqa
撑	solf
脏	vlay
蛮	mkyg
惟	wios
慎	dmoj
卜	nrfo
袁	jwef
孝	hbjx
躯	yrwm
屠	lrzj
捏	otlw
疾	udyq
申	dmgi
泽	vjdv
航	fley
晴	yxwh
漠	mndu
勤	yajc
狐	fute
祭	udth
坛	lkeh
剪	ucic
宏	fhok
扣	rylf
租	vuqg
裤	rupy
翁	worv
赫	fjee
框	rdnm
宿	tuos
喘	swfg
瓶	pxim
撤	sjly
遮	ejyp
奖	uvyk
诱	jgpq
喃	okfj
娃	wfce
妥	lnrc
昌	slww
昂	zlwt
豆	kvef
豆	kyef
巫	wujs
览	iksg
矛	msvu
刹	dfrs
堡	nsse
歇	htwt
勾	gytv
档	klnf
桢	emna
碍	zpkw
贺	fjcg
铃	ixvs
洒	tfdj
弓	ghza
泼	pndc
凄	ydym
祸	fnpf
逢	xotp
耻	sija
昭	eswc
罚	xjgp
罚	xfgp
宙	eyog
卑	nvwj
卑	niwj
逆	odip
盆	pwrg
呜	wuft
喂	wifg
饮	jatt
驾	ufcb
陛	ndxm
寺	tiej
骤	eybj
阅	jeui
妨	xlcy
绘	fabs
蜜	mdog
翔	hviv
签	ycqs
审	dmog
齿	sias
盼	pkgr
霜	ddln
廊	ilyp
刷	dezs
岩	jcgk
汪	wldh
综	vhbo
栏	ikni
媳	hdcw
猎	ittj
雕	kbts
疏	duxy
娶	yrjc
侠	hfsl
炉	irip
饱	nstt
戚	ydka
挖	wflo
泄	htdj
赢	jxyf
魏	wiqw
轩	hwmh
叛	pkie
薇	wiue
贞	emag
弥	mdzt
拨	nnlc
歪	wpkj
鼠	duwv
踢	ldfw
讽	xopt
账	elgq
莎	dfud
焉	jcjm
仔	vpsx
陵	ixxe
刑	hxhs
耍	dekc
帕	pfgw
盒	fjsg
芝	eiup
鉴	ucsv
腐	xuyg
慨	rpoz
赋	xugh
哟	jnfb
趟	llef
寞	mnou
劈	pdzc
漆	yddn
叉	sfvo
沟	gydt
谅	ivpy
披	pdlc
夕	hdto
摔	drly
愚	jrgp
宾	naow
歉	ycit
挽	wklt
吊	kbfg
宅	epoq
斥	sieo
灾	vpoi
梯	ldni
倩	ycsh
贪	lksg
怔	eooj
删	dkts
亿	jdsa
肤	xuah
植	einj
姆	mrcb
搁	gjlu
币	ndwi
液	jtdy
叙	hrsv
巾	uagi
倦	uwsi
谋	mypj
咽	jcff
砍	rkkt
滋	vidi
僵	uvse
柄	nxnj
锦	uavw
秒	mbqd
纱	dfbd
盈	jxcg
胁	htac
伪	wisi
崔	cags
筋	uaqa
冤	jwpt
腹	xuaq
刃	amco
糖	lliy
抑	jdlt
裳	dlfy
驻	euby
肖	hbfa
匪	xima
粒	idiy
莹	jxuh
嘲	ssfj
麦	mzht
撒	tflj
谣	jbpr
呈	sofh
绅	dmbg
咕	gufj
腔	yvao
辨	ncyi
撕	tilj
砸	vfkm
奏	vyhh
酷	rujq
艰	ucvz
卢	iraz
册	cjte
枯	runj
眨	efgr
斋	epyk
笨	nwqj
涨	eldz
鞭	ncjs
咳	fpfy
绩	udbh
雀	yeds
泡	psdt
掠	ijly
勃	nnjc
骄	ubbq
摊	lklv
虹	fhgj
谦	ycpi
姬	udcm
哄	fhfj
骚	tsbv
壶	fues
裹	gnyg
瞎	hfgo
誉	jroy
溪	hddr
柴	span
耸	thsj
纠	ugbx
跌	ktfq
污	wudh
绸	sybt
愉	jros
吩	xmfr
斤	uaei
饼	nxti
龄	ixas
贯	gwbg
隶	idzo
涛	lsdh
励	idkc
趋	yret
畏	wigm
饶	astm
辣	ifyj
霍	fnls
瑟	tjhp
哇	wffe
桐	lhng
仓	clsb
葛	gjuw
俱	ursg
帘	icog
樱	jxng
昆	rqwm
卓	enaj
瞒	mkgu
杭	flny
霄	hblf
翅	sijv
渔	jrdt
磁	ciki
役	jdet
墓	mrue
喉	fyfs
萝	inug
钉	kxvj
恒	fooe
械	htnm
骇	fpby
谨	uapj
抄	ssld
矿	rdky
衍	jced
闯	sdub
辅	xumj
棍	gqnw
旺	wlwh
珊	dkht
眠	mcgz
猴	fyts
菊	urut
俏	ybsf
漏	iydz
穴	heor
匠	uvme
跨	refk
狮	ditd
魄	pnww
迈	mzmp
蓬	pout
埃	zpev
宴	jcow
屑	htzf
邀	jbwp
拓	lnlk
廉	icyi
膝	hdan
揭	utlw
蠢	sqhg
绳	dobf
贾	ufjg
棋	ydnj
鄙	ndfx
爪	eeeo
填	lcej
棉	mcnw
蝶	ktgj
舟	eyeo
棒	nlnh
楞	iong
鹤	fjpt
晌	dlww
嵌	ycgj
患	fwgp
颠	kcjk
躬	ghwz
艘	tyew
邮	jggx
署	dugj
债	epsh
劣	itdc
捷	utlm
夷	jdmo
颈	uxvk
哩	idfg
湾	wkdy
轿	ubmq
枚	mvnq
枚	minq
遂	taip
绵	mcbw
谎	fdpu
剥	nnzs
誓	dily
嫩	owcj
衰	dryg
渴	rjdw
乳	aura
胞	nsat
婴	jxgc
诡	gapt
竖	dusy
蒋	uvuy
购	gygt
坟	xmey
藤	loua
契	ydhk
蕙	fauj
搂	iyli
违	wihp
戈	gjmo
筹	syqh
裙	yqpz
寡	geok
夭	jbqo
棵	rjng
弦	hczy
巷	hvjz
惶	fdow
婷	lxcy
煞	dfto
恍	fdof
寓	jrog
绣	hgbq
驳	nnbr
栗	idjn
驰	sibx
曹	csjw
苗	mbug
膊	nnaj
譬	pdzy
枕	emnp
杆	gknh
儒	ausl
兮	hdrm
蹲	kqfi
赚	ewgi
畅	slgc
赔	pvgy
赔	pigy
疗	ibyx
灌	gwdu
堵	krej
顽	wkhk
胳	gjat
宠	shok
冻	khym
羡	hciy
脾	pdaw
押	jflg
舱	cles
逝	dilp
揉	aylv
锅	gnvf
肌	udat
拢	ihlk
肠	slac
琪	ydhj
兔	lrto
恳	rmzp
雇	gups
悍	fkow
酬	syji
梳	duny
弗	xuzi
嗓	tlfv
拆	sple
嘱	eufz
哑	jffj
遣	ycgp
倚	jdsk
姜	uvic
赴	xuef
诀	uepz
芸	jquh
驶	dibg
妃	xicz
晰	hdwn
裸	inpg
浴	jrdr
氛	xmqr
腻	odam
蔡	cput
淫	jadr
後	fyeb
鸭	jfgt
浙	ejdl
涯	jfdk
逗	kvep
逗	kyep
妄	wlyc
怯	ytoe
筒	lhqg
敦	kqyq
乾	ycjq
刮	geqs
遵	vqip
逛	gdtp
魅	mvwh
魅	miwh
祁	ydpx
蜂	xogt
湘	hvdn
庸	jsyz
拘	urlt
凰	fdtw
眯	mdgi
矢	diqo
眸	mygv
旨	eitw
黛	kzsg
耽	kkjp
伐	xjsm
伐	xfsm
腕	wkao
甩	drta
诧	sfpo
凳	kovt
汝	audc
丘	ygwe
贱	ucgh
穆	mrqw
秃	lrqt
躁	vsff
烛	euig
杖	elnk
涵	fkdx
俯	xusy
烁	dnit
贡	ghjg
坠	eaxe
妓	udcj
坑	roey
陌	mnxk
侄	eism
篮	ikqs
沾	ekda
宰	vpoy
楣	mvnx
楣	minx
掀	hcle
妒	krcp
咧	itfk
撇	ptli
玫	mvhq
玫	mihq
痒	jvyi
哗	fefs
厢	hvkn
谱	prpi
滩	lkdv
壳	rjet
狭	hftl
谊	jdpo
鼎	kxgz
陀	lnxo
蕾	iiul
掘	uelz
瑶	jbhr
侮	wusq
践	ucfh
毅	jdyt
姻	jacf
僧	tosi
淋	iadn
叮	kxfj
殷	jaet
竭	utyw
葬	vluk
翰	fkjs
煤	mvij
煤	miij
鸦	jfmt
裕	jrpr
崩	noga
撼	fklk
棺	gwno
泣	yddy
灿	ckig
钥	jbva
拱	ghlj
磕	rjke
迭	ktqp
咯	inft
粹	caiy
昔	hdjw
斧	xure
苟	gyut
阀	xjus
阀	xfus
侦	emsa
哉	vpjf
拐	grlf
肆	tijz
堕	knxe
沫	mndh
愕	zjof
碑	nvkw
碑	nikw
颊	uflk
瞥	ptig
摄	djlj
噬	difq
噢	znfw
宛	wkot
铭	mxvt
敷	xujq
窜	cwog
啪	pffl
佟	lhst
笛	kdqg
惭	ckom
瑰	gahw
荆	uxus
倡	slsw
尬	gfks
糕	gsii
麽	meyt
尴	gkks
茵	jauf
携	htls
敛	icsq
棚	pona
渺	mbdg
仑	iqst
郡	uqzx
溃	radg
佑	jgsk
绮	ydbk
棠	llfn
衬	smpj
偿	slsf
鹿	irym
砖	ewkh
麟	iayi
囊	oljf
饥	udtt
售	dysf
绑	nlbh
暑	duwj
蔽	ndui
伺	tisz
宪	hcoq
廓	rnyy
黯	zkgy
颂	thrk
蕴	jqub
浸	uadz
樊	xknk
窄	epoq
嗽	tyfj
涩	tjdc
彭	poee
掷	eili
蝎	htgw
暮	mrug
莺	jxut
捐	uwlf
碌	irkz
芙	xuuh
诵	thpv
扁	ncpg
溢	jddi
捣	kslt
攀	pknk
税	daqi
岭	ixgs
崖	jfgk
斑	nkhy
淘	lsdt
卒	vuys
兜	kvwt
兜	kywt
槐	frnw
汹	hsdr
疆	uvze
绒	ahbm
窃	ytom
婶	dmco
茅	msuv
塌	lfew
削	hbfs
株	eunq
憎	vooi
摧	calg
坊	xley
歹	kzko
诊	emps
踩	cpfr
巍	wigq
匀	jqty
篷	poqt
澡	vsdf
隙	hdxd
帖	ltga
蓄	hruy
挪	onlz
辫	ncyb
桶	lhnv
恕	ducp
轨	gamt
逊	hqxp
憾	fkok
胎	lzav
禅	skpi
稚	eiqs
霓	odlw
乞	ydqa
缎	kwbw
兹	viib
嚣	hbfk
栈	eknh
龟	gatg
喻	jrfs
胃	wiga
昧	mvwh
昧	miwh
霉	mvlq
霉	milq
鞠	urjt
砰	pokl
捡	ucls
潘	pkdr
钩	gyvt
滨	nado
惩	soep
弘	fhzv
坎	rket
娅	jfcj
犬	ywko
歧	ydaj
哨	dsff
豹	nsrt
稽	udqk
颓	laqk
罕	fkph
啡	xifa
缚	xubj
肢	eiaj
袜	wfph
泊	nndw
蓦	mnub
襟	uapn
韦	wihi
朴	prnf
拂	xulz
谭	lkpj
搅	ublo
蚁	jdgi
怡	jdov
藻	vsud
脊	udya
荫	jaux
吏	idjo
缕	iubi
钞	ssvd
弧	fuze
枉	wlnh
雯	wmly
芦	irup
腥	hxaw
薪	hauy
晒	dpwj
嗡	wofr
靖	uxyh
筷	rrqo
娱	jrcf
嫣	jccj
衙	jfej
衔	hcev
逍	hbfp
橘	urnv
屡	iuzi
馨	haeq
妆	edyc
凸	lrae
衷	ehyg
兆	esrc
硕	dnkk
簇	cuqy
郊	ubyx
岚	ikgt
菩	pruy
纤	ycbq
岗	glgg
莽	mluk
寨	epon
盏	ekhg
嘶	tifj
褂	gepe
呻	dmfg
赠	vogi
焕	fwit
薛	heuw
啼	ldfy
朕	emai
圾	udet
琐	tnhf
垃	ifey
烤	rsij
滞	eidj
诞	kkpw
骆	inbt
暇	hfwz
桩	edny
蓉	ahuo
罐	gwqu
迦	ufcp
钦	yavt
锣	invg
菱	ixue
辽	ibxp
噪	vsff
辕	jwme
舜	dqrt
陋	iyxj
勿	wutu
毙	ndmk
帧	emga
狡	ubty
沸	xidz
盐	jceg
柯	rjne
姥	iscj
凛	iayy
嫉	udcy
筝	eoqt
烫	lldi
搏	nnlj
轴	eymg
斌	nayh
嗤	sifx
驼	lnbo
蔑	mtug
骷	rugj
徽	faeg
浏	igdy
霆	lxlq
脂	eiat
祷	ksph
艇	lxeq
咪	mdfi
呕	zyfm
髅	iygi
沐	mrdn
榜	nlny
焚	xmni
辜	gujy
呐	offg
尹	jazu
潇	hbdu
祈	ydpe
踱	knfy
弊	ndik
傩	onsv
颖	jxtk
邓	kovx
喧	hwfo
咦	jdfm
噗	prfs
惘	wlog
狸	idtg
剖	pyys
胧	ihak
坤	rqeg
梭	tnnv
症	eoyj
磊	iikk
煌	fdiw
趴	pffr
锤	savq
妾	ytyc
溅	ucdg
搀	sklt
娥	zjcq
擎	yxul
狄	kdti
镖	nbvj
膛	llaf
尉	wizj
朦	moau
驴	iubp
盔	rakg
嗦	tnfj
寇	ryoh
肿	ehag
盲	mlyg
滔	lsdr
囚	ygfs
拣	uclm
僻	pdsz
琼	yshy
蹈	ksfr
熙	hdjo
玖	ught
璐	irhf
煮	eujo
滤	iuda
喇	iffj
缀	eabv
虞	jraf
珑	ihhk
熬	zsho
旷	rdwy
佐	vnsk
灼	enit
潭	lkdj
栽	vpjn
傍	nlsy
窟	ruoz
贩	xkge
虐	ojam
弩	orcz
碟	ktkj
俘	xusr
陡	kvxe
陡	kyxe
丸	wkto
擅	dkly
匣	hfmg
婿	hrcx
雁	jcks
窘	usoz
虏	irac
秩	eiqq
恂	hqot
鸽	gjst
唧	udfz
巢	ssbg
瑾	uahj
肺	xiaj
诈	efpq
浆	uvyd
祺	ydpj
绽	ekbo
梨	idqn
捂	wulj
蜀	dugt
萍	pxud
梢	dsnf
蝇	jxgf
蒸	eoux
顷	yxmk
瞻	ekgt
嗳	zpfr
瓷	ciym
絮	hrcb
戮	irvm
梵	xknt
兀	wuka
绢	uwbf
寝	yaoy
堤	kdew
敞	slfq
蛙	wfge
咸	hcke
氓	mlyz
亩	mryg
沧	clds
帆	xkgt
瑜	jrhs
僚	ibsk
岔	sfrg
窥	raoh
捆	rqlf
伞	tksi
邱	ygwx
咚	khft
苹	pxul
杏	hxnf
嚼	ubfr
墅	duge
垫	kcle
沃	wndq
狞	oxto
瞳	lhgy
鹅	zjqt
谐	htpm
醋	cujj
塑	tuie
俞	jrsa
嘎	gffk
诅	vupg
澜	ikdu
栋	khnm
彬	nann
黎	idqs
履	iuze
胀	elaq
讥	udpt
嗔	smfj
咙	ihfk
榻	lfnw
纽	ogbx
柏	nznw
烘	fhij
挟	htll
憋	ntip
揣	srlg
锡	hdvw
箫	hbqz
荐	ucuk
麒	ydyj
眷	uwig
卸	htqx
蹦	nofg
钮	ogvx
稻	ksqr
朽	hgnm
峡	hfgl
蹄	ldfy
庚	goyz
蜡	ifgj
淹	jcdk
腮	tpag
斟	emjo
捞	islu
缸	glqj
奢	djkj
喽	iyfi
魁	rawo
阮	awxh
阎	jcut
撰	ewlz
挠	oslm
绰	snba
擒	yals
丐	gpja
鳞	iati
垒	iive
翘	ybmv
毯	lkqi
廖	ibyv
嗜	difj
冗	ahpt
狈	nvtg
狈	nitg
讳	faph
锻	kwvw
铠	rpvg
蛛	eugq
肝	gkah
寥	ibov
孽	otuw
汁	eidj
蝴	fugj
抿	malz
耿	goji
裴	pvay
裴	piay
叭	nffr
贸	mstg
聘	pajg
塘	lley
厮	tikj
粘	ocia
讪	dkpg
蚀	ditg
茹	auuc
啥	dffs
闺	gaue
唾	lnfq
琢	enhk
琉	ighy
铨	ywvs
蕊	aaup
匙	diwt
禀	nxyg
炽	siif
踌	syfh
剂	udys
葡	prut
乍	efqe
蚂	mfgb
腊	ifaj
揪	uglq
袄	zspq
嚎	fsfy
炒	ssid
庵	zkyk
睹	krgj
萄	lsut
茂	msuk
哮	hbfj
嘘	hrfa
摹	mnul
涡	wndf
芽	jfum
跋	nffk
尧	jbmk
炭	lkgk
渗	dmdv
禽	yasy
瞄	mbgu
鲍	nstt
叩	ryfx
酱	uvyj
搓	cnli
伶	ixss
枣	vsjo
浦	prdj
郝	fsex
届	utzg
宵	hbof
膜	mnau
拙	enlx
滥	ikds
坪	pxel
哆	knft
禄	irpz
炕	rliy
揍	vylh
沦	iqds
畜	suyg
扛	rllj
檐	jcnt
绞	ubby
挚	eill
敖	zshq
镶	hvvy
嗅	hgfw
粥	eyzi
吱	eifj
瓣	nkye
怅	sloq
匕	ndta
躇	sufu
蚊	wmgy
遁	kqep
浇	ubdm
淮	frds
屯	lqma
耕	gohh
葱	chut
徘	pzea
卦	geef
戳	snvm
霖	ialn
揩	rplm
熄	hdiw
殖	eikj
阈	jrum
慷	rloy
廿	ocje
悯	maou
蔼	zpup
绷	noba
蒲	prud
畔	pkgi
徊	frea
猾	fetg
丞	soxe
瘾	jayx
彦	jcye
膏	gsya
咆	psft
拧	oxlo
纲	glbg
铸	euvh
忿	xmrp
窍	yboj
萱	hwuo
逮	kzzp
诬	wupj
懊	zsow
剔	ldws
旱	fkwh
绯	xiba
婢	ndcw
钓	kbvt
雍	jsyb
峻	uqgv
撩	iblk
掐	yflt
燥	vsif
祀	tipz
侣	iusf
璧	ndzh
铅	ycvt
翩	pcpv
芯	haup
倭	wnsq
簿	nrqd
萌	mouw
悼	ksoa
虾	hfgj
眩	hwgy
辟	pdzy
彪	nbae
熏	hqqo
浊	endg
祟	taxh
谬	mgpv
啧	vjfh
渠	yrdn
眶	rdgm
俨	jcsj
庶	duyo
喀	rffo
漾	jvdi
灶	vsie
俺	zksk
庐	iryp
聂	otjv
觅	mdrg
阱	uxxh
戟	udjm
呃	zjfk
懦	onol
胶	ubay
殆	kzkv
挫	cnls
橱	sunk
蟹	httg
阐	skui
孕	jqcx
扳	nkle
颐	jdjk
屉	ldzj
瞅	sygq
襄	hvyf
骸	fpgy
棱	ione
冀	udag
竿	gkqh
葫	fuuj
禹	jrwo
咏	jsfp
肘	eyaj
痰	lkyi
拴	dwls
傀	rasw
昼	eyzw
迸	noip
澄	sodv
桓	fwne
栅	dknt
靡	mdya
梧	wunj
尿	obzd
唔	wufj
瘫	lkyv
捶	salq
诛	eupq
冉	akge
珂	rjhe
咖	gffc
吁	jrfh
螺	ingg
滢	jxdu
酿	ovjp
揽	ikls
旭	hrtw
剃	ldis
韧	amhc
怠	kzvp
丙	nxjo
疤	nfyx
蝉	skgi
溯	tudi
唠	isfu
帜	eigf
豁	fnor
贮	eugo
谜	mdpi
儡	iisg
勋	hqfc
揖	jdlf
叽	udft
侃	rksf
搔	tslv
拇	mrlb
惚	fuot
驯	hqbw
矫	ubqq
聋	ihkj
颅	irak
瞟	pbgj
泻	htdp
洽	yfds
绥	tabr
祠	cipz
呸	pvfk
呸	pifk
涕	lddi
悴	caoy
榴	ignt
涅	otdw
叱	sift
馈	ratg
淌	lldf
跺	knft
鹃	uwft
惕	ldow
彤	lhte
喳	effn
嘈	csfj
筐	rdqm
藩	xkud
苑	jwut
旬	hqtw
酌	enjt
觑	yrag
凹	zsge
厥	ueki
琦	ydhk
亥	fpyo
嬉	hdce
舆	jrwr
瑚	fuhj
惫	nvtp
惫	nitp
秽	faqg
漓	iddy
昊	fswh
镯	envg
蔚	wiuz
拭	dilm
甸	kctg
沪	fudp
弛	sizx
酥	tujq
铲	skvy
绊	nkbi
萎	wiuq
臀	lqza
棘	udjj
钊	esvs
抒	dulv
匿	odmu
敝	ndiq
唬	fufa
髦	msjq
蝠	xuge
斐	xiay
龚	ghkj
亨	foyf
拷	rslj
憔	ybos
钰	jrvh
樵	ybns
秉	nxqo
鬟	fwjg
懈	htot
澈	sjdy
赘	eahg
侨	ybsq
歼	uckq
蛊	gugg
倏	dust
煎	ucio
苛	rjue
擂	iill
娟	uwcf
晦	fawq
疙	gjyq
厕	cjkg
靴	hejs
剿	ubbs
虔	ycay
梗	gonj
舔	lcqh
晖	fawp
歆	hayt
珏	uehh
芭	nfux
邵	dscx
蕉	ubus
檀	lkny
蚕	ckhg
仄	vjks
辙	ejmy
泳	jsdp
幢	edgy
札	efna
蜘	eigq
淳	sqdy
疫	jdyt
冶	jtyv
翎	ixsv
咨	viyf
猿	jwte
霎	dfly
隋	taxk
彷	pley
粪	xmij
甭	nokt
飙	nbkt
惋	wkoo
汀	lxdj
沛	pvdj
沛	pidj
砌	ydkm
炫	hwiy
蚩	sixg
钝	kqvm
惦	kcoy
奚	hdrb
犀	hdzd
韬	lshr
噩	zjjf
拌	nkli
厦	hfkk
偎	wisg
楠	oknj
冈	glgr
鬓	najo
溶	ahdo
笃	krqb
婪	iknc
慑	djoj
瀚	fkdj
藉	utuh
璇	hwhy
疚	ugyt
菁	uxuh
砂	dfkd
绎	jdbv
窑	jboq
袱	xups
沮	urdg
巩	ghjt
蛟	ubgy
阑	ikuj
茜	ycuj
妩	wuch
狰	eott
窒	eiom
鞘	ybjf
呛	yvfs
绫	ixbe
兢	uxjj
壤	aley
跄	yvfs
踉	ivfp
牡	mrqe
囔	olfj
惮	kkoi
墟	hrea
攘	ally
楷	rpnm
沁	yadp
缄	ucbk
募	mruc
啃	rmfa
霹	pdlz
缉	udbf
澳	zsdw
肋	iiac
砚	jckg
贬	ncgr
憨	fkzp
匈	hstr
棕	vhno
倪	odsw
槽	csnj
狙	urtg
馒	mktw
膨	poae
拽	erlg
拎	ials
矗	sujj
崭	ekgm
炯	usig
猩	hxtw
厄	zjkb
杠	glnj
崛	uegz
奎	rake
坝	nfeg
渣	efdn
撅	uelk
糙	csiq
倔	uesz
忖	cqoj
兑	kaif
卵	iwtx
榆	jrns
曳	jtgu
漱	dudj
朔	dnia
雳	idlk
缴	ubbw
赎	dugj
屎	dizi
蹭	cofi
溺	oddz
睬	cpgr
捻	ocls
棣	kdnz
苇	wiuh
蹬	kofv
菌	uquf
吝	iayf
褪	lapz
笙	doqq
垮	reek
亢	rlyt
踹	srfg
峙	eige
篱	idqy
逞	sofp
攒	vklq
漩	hwdy
髓	tagk
峭	ybgf
桨	uvyn
笺	ucqh
俭	ucss
蹋	lffw
巅	kcgj
稣	tutq
瀑	prdw
陨	jqxf
勺	dsto
峨	zjgq
铮	eovt
曙	duwg
撮	cnlw
穹	ysoz
凿	vssi
罡	glgj
汰	lzdk
矜	uavs
筛	dpqd
穗	taqj
锥	eavs
刁	kbze
枢	dunm
苔	lzuv
喔	wnfz
隅	jrxg
皂	vswm
瘪	ntyw
吠	xifk
烙	isit
舵	kneo
沼	esdc
诏	espc
憧	shoy
辖	hfmo
崎	ydgk
邹	vytx
黝	jggb
袅	obty
恬	lcoq
鸳	jwtt
璋	elhy
眺	lbgr
胭	jcaf
湛	ekdj
驭	jrbv
奕	jdyk
闸	efug
煽	dkip
椒	ubna
琅	ilhp
炙	eiti
镰	icvy
褥	aupk
靶	nfjx
锯	urvz
柿	diny
髻	udje
扒	nflr
赦	djeq
睫	utgm
蹙	cukf
陕	dkxl
毋	wube
壕	fsey
佬	issj
熹	hdeo
侈	sist
衅	hawi
塾	duye
冕	mcwt
茸	ahuj
盅	ehgg
瑛	jxhu
漪	jddt
稼	ufqo
肮	zlay
簌	tuqj
嗖	tyfw
酣	fkjj
拯	eolx
盂	jrhg
骡	inbg
妲	kfcw
翡	xiav
瘩	kfyu
蔓	wkuw
荀	hqut
券	ywic
蝙	ncgp
鸯	jvgt
窿	ihox
谍	ktpj
炳	nxij
亵	htyl
寅	jaoj
厘	idkg
殉	hqkt
啐	cafy
碾	ockz
仕	dise
炀	jvic
裔	jdyg
姗	dkct
芜	wuuh
庇	ndym
玺	hdth
奠	kcik
蠕	augl
缭	ibbk
疮	sdys
涎	hcdw
娼	slcw
逾	jrsp
癸	gavh
榕	ahno
涣	fwdt
邸	kdtx
睿	aaag
饺	ubty
皓	fswq
忏	skoq
隧	taxi
孰	duyt
惺	hxow
晏	jcwo
滕	loai
谛	kdpy
螃	plgy
捅	lhlv
缆	ikbs
奄	jckg
铎	knvv
杉	dkne
抡	iqls
晤	wuwj
拈	ocla
澎	pode
佘	djsh
匾	ncmp
熔	ahio
婕	utcm
谕	jrps
颁	nkrk
毡	ekqa
彰	elye
媛	jwcr
骏	uqbv
茄	ufuc
茧	ucug
殴	zymt
脯	praj
嗣	tifz
雏	suts
蒜	twuh
嵇	udqk
娄	iyic
琛	smhp
捺	oflk
馋	sktt
俐	idsq
褐	fjpw
镑	nlvy
崽	vpgg
幺	jbbo
鹫	ugyt
鹦	jxgt
叼	kbfz
詹	ekty
恃	dioe
胤	jaub
阙	yeui
锄	suvg
茉	mnuh
遏	zjwp
悚	thoj
蜷	ywgi
睨	odgw
瘟	wmyw
暧	zpwr
篓	iyqi
芊	ycuq
簸	nnqj
蛰	ejlg
饷	hvtw
烹	poyo
茨	ciuy
磅	nlky
蟒	mlgu
屿	jrgm
暄	hwwo
辄	ejmj
宦	fwom
驹	urbt
锢	guvf
迢	lbcp
咋	vffq
噎	jtfe
蔷	yvuj
萤	jxug
裘	ygjy
扼	zjlk
辐	xume
潺	skdz
窦	kvoj
窦	kyoj
悖	nvoj
悖	nioj
褒	nsys
眈	kkgp
驿	jdbv
烬	uaiz
匡	rdmh
瑕	hfhz
掺	sklv
绚	hwbt
贷	kzsg
箍	guql
咄	knfx
啤	pdfw
炊	sait
簧	fdqj
懿	jdey
殡	nako
沏	yddm
湃	pzdl
癖	pdyz
浒	fudp
悸	udoq
诫	utpm
籁	izqj
徨	fdew
鞍	zkjo
迂	jrhp
飕	tytw
蛤	ffgs
甬	jsvg
愫	tuoh
熠	jdiv
瓢	pbje
桔	urne
欤	jrmt
盹	kqgm
巳	tiza
俟	tisv
殃	jvkg
腆	lcag
谑	hepa
孜	vixq
牟	myvq
贿	fagk
吮	dqfv
惆	syot
笋	tqqz
粱	ivdi
鸾	iwyt
榨	efno
橙	sonv
恺	rpog
嫦	slcf
咎	ugtf
渍	vidh
蹂	ayfv
诃	fjpe
鲸	uxty
墩	kqey
啄	enfk
恙	jvip
蔬	duux
昵	odwz
缨	jxbg
栖	ydnj
橡	hvnt
戬	ucjm
薯	duug
趾	eifa
坍	lket
钗	spvv
桦	fens
秤	soql
椭	lnnx
嗷	zsfh
痞	pdyk
稷	udqg
躏	iafu
萦	jxub
醇	sqjy
恤	hrow
吭	rofy
纺	xlby
嫖	pbcj
羲	hdiq
窖	uboq
癞	izyj
臊	tsaf
凋	kbyt
稠	syqt
钵	nnvj
埠	nrew
锵	yvvy
袒	lkpw
炬	urim
葵	rauv
踞	urfz
桀	uttn
枷	ufnc
勘	rkjc
鹉	wuht
雌	cias
伽	gfsc
缔	kdby
缅	mcbk
蟆	mfgu
偌	ansu
嚓	sffo
驸	xubs
颔	fksk
婊	nbch
酋	ygij
褚	supj
舐	diqt
惴	eaog
麾	fayq
惰	knok
偕	htsm
筵	jcqw
孺	auxl
谴	ycpg
貂	kbrc
洼	wfde
攥	vwlq
帷	wigs
枭	hbtn
羁	udgj
咔	rffa
蹑	otfj
涧	ucdu
梆	nlnh
磋	cnki
睦	mrge
馅	hctt
赁	iasg
嗟	utfi
舫	xley
玑	udht
烽	xoit
礁	ubks
佯	jvsi
垢	gyee
狩	dyto
汲	uddt
迄	ydqp
帚	eyzg
谤	nlpy
槛	rkns
腑	xuay
怦	pool
咀	urfg
忑	lejp
渝	jrds
肴	jbrk
羿	jdvk
娲	wfcf
畴	sygh
搐	suly
猥	witg
聆	ixjs
煜	jriw
禾	fjqo
闽	maug
忐	lkap
赃	vlgy
诲	fapq
荤	fqum
猝	cuty
羹	goii
紊	wmyb
冢	ehpk
蹿	cwfo
幔	mkgw
戾	idpk
藕	zyuh
魇	jckw
缥	pbbj
掂	kcly
猖	sltw
锈	hgvq
鸠	ugtt
舷	hcey
戊	wuko
薰	hquq
菇	guuc
撵	oclh
幡	xkgr
啬	tjjf
痹	ndyg
麓	irny
戎	ahmk
甄	emjm
琶	pfhx
桅	wint
腼	mcak
祯	empa
幌	fdgw
侥	ubsm
纣	eybj
饲	titz
垣	jwee
涤	kddt
栩	hrnv
诩	hrpv
骼	gjgt
癫	kcyj
唆	tnfv
汩	gudw
蜒	jcgw
喋	ktfj
鹊	yejt
琵	pdhm
鲨	dfdt
皙	hdnw
屹	jdgq
谚	jcpy
缜	embj
瓮	worm
崆	rhgo
缈	mbbg
畸	udgk
邃	taop
邑	jdfx
忡	shog
跷	ybfm
掣	sjql
苞	nsut
葆	nsus
竺	euqh
膳	dkai
卤	iraf
坳	zseb
秧	jvqg
孚	xurx
篆	ewqb
寐	mvox
寐	miox
伎	udsj
隘	zpxi
甥	doqg
卉	fajk
沥	iddk
坞	wuet
蘸	ekuj
嵩	thgy
毗	pdgm
粟	tuji
隍	fdxw
蕃	xkur
哒	kffk
啷	ilfp
鼾	fkwh
栓	dwns
酉	jgje
骋	sobg
睽	ragv
砾	idkt
藐	mbur
纨	wkbt
毓	jrqy
璀	cahg
啰	infg
腋	jtay
阜	xuwj
泓	fhdz
鸥	zymt
卯	mstx
衮	gqyr
簪	vkqm
羔	gsio
飓	urtg
劭	dscc
铿	rovs
璨	ckha
龊	snaf
掳	irla
潦	ibdk
犄	udqk
饵	zitj
镔	navo
龌	wnaz
圃	prfj
颉	utek
铛	klvf
壑	fjae
谄	skpt
邢	hxhx
绉	eybt
惬	ytom
臧	vlkm
绛	uvbt
芥	utus
蜕	lagi
蜿	wkgo
酝	jqjh
煦	hrwo
遐	hfzp
镣	ibvk
粤	jewm
冽	ityk
蜥	hdgn
缰	uvbe
豚	lqak
璞	prhs
靳	uaje
壬	amqe
卅	tfki
皎	ubwy
拄	euly
糜	mdyi
殓	icks
姣	ubcy
龛	rksk
霏	xila
忱	smop
蜻	yxgh
丕	pdke
扈	fupf
啜	snfv
碴	sfkn
钳	ycvj
笠	idqy
筏	xjqs
筏	xfqs
驮	lnbk
粽	vhio
庠	hvyi
翱	zswv
撂	iblg
垄	ihke
讷	oepg
诣	jdpt
谏	ucpj
讹	zjps
贻	jdgv
帛	nnwg
黔	ycgs
椎	eans
瞿	yrgs
佃	kcsg
娓	wicz
纂	vwqg
攫	uelg
蘑	mnuy
阖	fjue
蛐	yrgg
饯	ucth
臻	emmh
亘	gmew
蝗	fdgw
咫	eizf
蛾	zjgq
渲	hwdo
纬	wibh
馁	oitr
瞌	rjge
篡	cwqg
醺	hqjq
谒	jtpw
昕	hawe
汶	wmdy
屐	udze
茬	sfuk
瀛	jxdy
鹭	irft
霭	zplp
飒	tfyt
漉	irdy
曦	hdwi
胯	reak
捎	dslf
痊	ywys
掸	kkli
瘸	yeyc
戌	hrke
楫	udnf
搪	llly
磐	pkek
昱	jrwy
螂	ilgp
梓	viny
犁	idqq
嫡	kdcy
鄂	zjfx
珀	pnhw
豺	sprj
隼	tqsj
蜓	lxgq
茗	mxut
踵	ehfq
晾	ivwy
彝	jdbi
瘴	elyy
嚏	ldfj
瞩	eugz
懵	moou
鹳	gwut
峦	iwyg
瞠	sogf
娣	kdci
锚	msvu
掇	knlv
谟	mnpu
刨	psts
傧	naso
黏	ocqa
硝	hbkf
陇	ihxk
饽	nntj
蟾	skgt
拗	zslb
怂	thsp
胄	eyga
筠	jqqe
乓	plwo
垛	knet
跤	ubfy
岌	udgt
弁	ncvk
濂	icdy
睇	kdgi
骈	pcbi
叟	tywv
掰	nzlr
岱	kzsg
蟀	drgy
颍	jxtk
铐	rsvj
呓	jdfu
偃	jcsm
咿	jdfs
禺	jrgo
玳	kzhs
舶	nnew
镌	uwvs
燎	ibik
缪	mgbv
闵	mauy
荔	iduc
莘	hauy
吒	effq
攸	jgsq
慵	jsoy
褶	ejpv
谀	jrpq
萃	cauy
赂	irgt
讼	thpr
箩	inqg
怩	odoz
瘁	cayy
贰	zimh
懋	msnp
淞	thdn
瞰	rkgz
肇	espz
嘭	pofe
扉	xipa
瞑	mxgp
倌	gwso
翟	epvs
杞	ydnz
烨	jtis
辗	ekmz
佗	lnso
掖	jtly
霁	udly
锭	kxvo
邬	wutx
熵	dliy
沽	gudj
膺	jxya
舀	jbrw
搽	sflu
羌	yvia
殇	dlkq
挛	iwyl
鳄	zjtf
孵	xutr
苓	ixus
痪	fwyt
俸	xosh
颦	paaw
淀	kcdo
逵	raep
噔	kofv
乒	pxwu
岑	cmgs
嵋	mvgx
嵋	migx
耷	kfkj
侏	eusq
骁	hbbm
腴	jraw
馀	jrts
镂	iyvi
赳	ugex
佼	ubsy
蛆	yrgg
祢	mdpt
氧	jvqi
箕	udqj
溟	mxdp
鞑	kfjk
聿	jrzi
镀	krvy
诽	xipa
暨	udzw
噘	uefk
椰	jtnj
琥	fuha
阉	jcuk
杳	jbnw
柬	ucjo
夙	tutk
痘	kvye
痘	kyye
鲤	idtg
俾	ndsw
揿	yalv
蜗	wngf
媲	pdcw
虬	ygga
戍	duko
荧	jxui
擞	tyli
蟋	hdgr
靓	ivhg
蜈	wugf
蚣	ghgr
诘	utpe
涸	fjdf
橹	irnt
茎	uxuv
嚅	aufl
豢	fwik
疵	ciya
恿	jsvp
遽	urap
榭	htnw
缤	nabo
韶	dsyc
鳌	zsht
迥	usgp
憩	ydqp
黠	hfge
槌	sanw
闩	dwue
赊	djgs
篙	gsqy
杵	sunq
沂	jdde
忒	limp
芍	dsut
粲	ckai
捋	iulr
呗	nvfg
呗	nifg
渭	widg
阂	fjuy
赈	emgk
宓	mdop
宕	klok
瑙	oshb
蓓	nvus
蓓	nius
蜴	jdgw
瑁	mshg
虱	diaw
侬	ohsp
吨	kqfm
伫	euso
嘹	ibfk
纶	iqbs
罔	wlgi
娑	tndc
闰	aquh
圳	emew
颏	rjyk
怆	sdos
髯	akjg
窈	jbob
痉	uxyv
哺	nrfj
蔗	ejuy
喵	mbfu
耘	jqhh
斓	ikyu
喟	rafg
呦	jgfb
嘤	jxfg
炖	kqim
昙	lkwh
岐	ydgj
汴	ncdy
戛	ufkm
荼	lrus
嗥	fsfw
胚	pvak
胚	piak
匝	vfmg
诌	eypt
笆	nfqx
蟠	pkgr
咛	oxfo
裱	nbph
曜	jbwv
噫	jdfy
氅	slfq
溥	prdj
弑	dirm
掬	urlt
垦	rmze
窠	rjog
茁	enux
淆	hbdr
芹	yaue
诳	rdpt
泞	oxdo
筱	hbqs
篝	gyqh
剁	knts
恸	lhoh
旌	uxyq
盎	zlgg
抠	rylm
桧	gans
刍	sutz
罅	hfqa
莞	gwuo
蜃	dmkg
鑫	havv
璜	fdhj
跚	dkft
蹩	ntif
轶	jdmq
亟	udxe
磷	iaki
蚌	nlgh
娆	ascm
窕	lbor
孑	utxe
榄	ikns
硫	igky
泯	madz
濒	nada
衾	yasy
潼	lhdy
滇	kcdj
颧	ywuk
悒	jdof
踊	jsfv
闾	iuuf
臆	jday
嗝	gjfe
踝	frfg
溉	gpdz
玷	kcha
痨	isyu
峥	eogt
旎	odyq
瘠	udyy
臃	jsay
褛	iupi
谆	eqpy
抉	uelz
怏	jvog
斫	enke
邯	fkjx
诙	fapk
靥	jtkk
隽	uqsc
蹒	pkfu
褴	ikps
涔	cmdg
柩	ugnm
橄	gknz
滓	vido
鸨	nstt
赭	ejej
衲	ofpg
剐	gefs
粼	iaib
撬	yblq
纾	dubv
啻	siyf
诒	jdpv
谩	mkpw
牍	krwj
泌	mddp
玮	wihh
釜	xurh
堰	jcem
谧	mdpp
诿	wipq
剽	pbjs
橐	lnjk
讴	zypm
鳅	ygtq
囤	lqfm
痢	idyq
绺	igbt
啕	lsft
畦	ydge
芋	jruh
涮	dwdz
晟	dowk
胴	khag
荃	ywus
礴	nnku
郢	jxfx
皿	mage
踅	helf
顼	hrhk
蚯	yggw
诮	ybpf
曝	nsww
糯	onil
聒	gnjq
弼	ndzk
鲲	rqtw
贲	nwjg
轼	dimm
堑	ycme
蚓	jagz
诨	fqpp
啮	otfa
炜	wiih
圭	gaee
旖	jdyq
淼	mbdd
鹂	idet
辘	irmy
袂	mvpz
袂	mipz
弈	jdyk
癌	zpyf
谪	ejpy
庖	psyt
鹞	jbrt
笈	udqt
嵘	ahgu
哔	ndfm
怄	zyom
肾	dmsa
匐	xute
乩	udaa
脐	yday
坷	rjee
皋	gswk
哂	dmfj
蚪	kvgo
蚪	kygo
霾	mzlr
糠	rliy
泸	irda
雹	nslt
眦	viga
胰	jdam
涿	endk
焊	fkiw
锹	ybvq
饬	sitq
敕	sijq
诋	kdpt
翌	jdvy
轧	jfma
氢	yxqv
珞	inht
饨	lqtm
婧	uxch
缇	ldbw
诠	ywps
坯	pdek
俑	jssv
俚	idsg
茱	euuq
蚤	vsvg
佻	lbsr
恪	rjot
浣	fwdo
馄	fqtw
芮	aaug
樟	elny
矶	udkt
辍	snmv
犊	krqj
魑	siwy
娌	idcg
蚱	efgq
骊	idbe
猬	witg
迩	zitp
蝌	rjgq
辎	vimb
豕	diko
妯	eycg
珈	ufhc
菠	nnud
骠	pbbj
搡	tllv
箸	euqj
碉	kbkt
佥	ycso
裆	klpf
蔻	ryuo
篇	pcqp
遑	fdwp
饕	lsfs
懑	mwdp
柢	kdnt
嬷	mncy
淙	chdo
恫	khog
卞	ncyo
挎	relk
捱	zplk
猢	futj
蹶	uefk
轲	rjme
孪	iwyx
鳖	ntio
蹊	ydfr
佚	jdsq
瘤	igyt
泱	jvdg
钏	swvw
幛	elgy
螳	llgf
骥	udba
馍	mntu
刽	gass
氲	jqqw
绔	rubk
郜	gsqx
槟	nano
兖	jcyr
诟	gype
睐	izgl
脓	ohap
皑	zpwg
鸢	jwmt
燮	htyv
莓	mvuq
莓	miuq
淬	cady
侩	rrss
孀	ddcl
讣	xupf
鲫	udtz
狲	tqtx
垠	jaez
楮	sunj
琏	ichm
嬴	jxyf
晔	jtws
俪	idse
汕	dkdg
邺	jtsx
斡	wnjs
犷	gdty
鹑	sqyt
锏	ucvu
椿	sqnh
蛀	eugy
滂	pldy
琨	rqhw
蹇	ucof
摒	nxlz
馥	xuqq
峒	khgg
觞	dltq
衢	yreg
臼	ugwe
渤	nndj
餮	ltks
咣	gdff
邋	ifbp
趄	yteg
臾	jrwo
淖	enda
遢	lfwp
闇	zkzy
钹	nnvk
氤	jaqf
鬃	vhjo
牯	guqj
皖	wkwo
椽	swnb
跛	nnfc
佞	oxsh
纭	jqbh
痣	eiye
姘	paci
靼	kfjw
噶	gffu
妪	jrcm
绾	wkbo
扪	mwlu
濯	endv
檬	monu
榷	yenp
迳	uxvp
徵	eoeg
呶	osfc
伧	clss
幂	mdpw
伢	jfsm
缙	uabj
梏	gunq
彗	fahz
魍	wlwg
浃	ufdl
婵	skci
铡	efvg
赡	dkgt
挲	tndl
鸷	eilt
忤	wuoq
柚	jgng
碳	lkkg
耙	pfhx
颌	fjsk
渥	wndz
挞	lflk
讫	ydpq
掮	yclp
蝼	iygi
摺	ejlv
邕	jsbf
翳	jdkv
喙	fafb
罄	yxeq
煨	wiig
颀	ydek
嶙	iagi
咝	tifb
泅	ygdf
蒿	fsuy
蟑	elgy
獭	lftj
鬈	ywji
祗	eipt
辇	ochm
皈	gawe
俎	vusg
猷	jgik
龇	viaa
裟	dfdy
耄	msjq
笞	siqv
谙	zkpy
潞	irdf
箧	ytqm
酪	isjt
飚	nbti
揶	jtlj
袈	ufcy
缮	dkbi
阕	yeuv
琰	jchi
晁	sswr
荟	faus
骜	zshb
峋	hqgt
砥	kdkt
鹄	fuqt
夔	raiw
蛹	jsgv
腺	hcaw
犒	rsqy
湍	lwdg
赧	okex
阗	lcuj
銮	iwyv
羚	ixis
忪	thor
镭	iivl
獗	uetk
摈	nalo
峪	jrgr
暹	hcwp
豌	wkeo
恹	jcok
忾	rpoq
闳	fhuk
蠹	krjg
濑	izdj
抨	poll
叵	pnmf
呲	vifa
踮	kcfy
粑	nfix
挈	ythl
谗	skpt
勖	hrgc
柠	oxno
胛	ufag
纫	ambc
翕	hdsv
坂	nkee
欹	ydkt
唢	tnff
鸪	gujt
酵	ubjj
韭	ugae
桠	jfnj
魃	nfwk
铝	iuvf
磺	fdkj
篑	raqg
靛	kcho
潢	fddj
觊	udgg
牒	ktwj
郸	kkix
傥	llsf
岫	hggg
榛	emnh
鳝	dkti
钺	jevm
匮	ramg
铳	shvy
鸶	tibt
馔	ewtz
觎	jrsg
磬	yxek
桎	einm
樽	vqni
蹰	sufk
仞	amsc
琬	wkho
馊	tytw
诰	gspq
偻	iysi
奁	ickm
檄	hdnw
蠡	idbg
疹	emys
棂	ixnz
柑	gknj
巽	hqzj
蠊	icgy
汛	hqdz
遨	zshp
汾	xmdr
殛	udkx
麝	djyw
喑	jafy
遛	igtp
蛔	fagf
菡	fkux
唁	jcfy
贽	eilg
戕	yvxm
饪	amtq
畿	udbg
爰	jwrh
煊	hwio
弋	jdmo
讦	utph
钜	urvm
铄	dnvt
蜢	mogx
燧	taii
苜	mrug
呤	ixfs
僖	hdse
鸩	empt
弭	mdzj
灸	ugti
釉	jgrg
碱	uckk
愠	jqow
迨	kzvp
锟	rqvw
揆	ralv
蹴	cufy
狎	hftg
淄	vidb
缢	jdbi
腌	zfak
洱	zidj
玥	jeha
阒	yrug
楔	htnh
掼	gwlb
硅	gake
鹌	zkkt
麴	yrjt
仃	kxsj
艄	dsef
镳	nbvy
夯	flkc
螓	yagh
昀	jqwt
蓑	tnuy
堇	uajg
奂	fwtg
褡	kfpu
涝	isdu
撷	htle
悌	ldoi
迤	jdqp
鹧	ejyt
忻	haoe
苯	nwuj
沣	xodh
邝	rdyx
埔	prej
颚	zjfk
浚	uqdv
耆	ydjw
蓟	udut
瑄	hwho
翊	jdyv
榔	ilnp
糗	ygiw
跻	udfy
捍	fklw
翦	uciv
埂	goej
觐	uajg
橇	ybnq
竣	uqyv
秆	gkqh
铢	euvq
媪	zscw
睚	jfgk
胫	uxav
磔	ejkt
肪	xlay
澹	lkdt
黜	sugx
帏	wigh
泗	tidg
獒	zshk
谲	uepv
榈	iunu
楹	jxnc
忝	lchf
嫔	paco
趔	itek
骛	wuvb
笏	fuqt
踽	urfw
睑	ucgs
琊	jfhm
帼	gngf
焙	nviy
焙	niiy
铀	jgvg
漳	eldy
孬	oskc
赣	gkyt
倨	ursz
螭	sigy
脍	rras
粕	pniw
肱	ghak
倜	ldst
萼	zjuf
黍	duqs
箔	nnqd
噌	cofi
祚	vnpq
诓	rdpm
砺	idkk
斛	futo
覃	yajw
杷	pfnx
撺	cwlo
觥	ghtf
恚	faep
磴	kokv
柘	ejnk
睥	ndgw
婠	wkco
绦	lsbt
誊	loiy
蜮	jrgm
霈	pvld
霈	pild
膘	nbaj
啖	kkfi
沱	lndo
罂	jxgq
荑	jdum
鲛	ubty
徇	hqet
骧	hvby
苋	hcug
摞	inlg
唳	idfp
鳗	mktw
荚	uful
僭	ucsm
鏖	zsyv
谡	tupg
箬	anqu
枇	pdnm
袤	msyv
杈	sfnv
湫	ubdq
烩	fais
荩	uauz
泾	uxdv
鸵	lnto
濛	modu
宥	jgok
羯	utiw
哐	rdfm
诤	eopt
桉	zkno
汐	hddt
狷	uwtf
熨	jqzi
襁	yvpz
谯	ybps
跎	lnfo
锷	zjvf
睢	tags
髭	vija
泵	nokd
聩	rajg
臌	guae
湄	mvdx
湄	midx
恁	owsp
儆	uxsu
葩	pfuw
逖	ldtp
荞	ybuq
盥	gwwg
癯	yryg
钛	lzvk
妤	jrcv
葺	yduf
锃	vovf
啵	nnfd
牖	jgwp
绡	hbbf
箝	ycql
蹉	cnfi
钠	ofvg
囫	fuft
秸	utqe
虻	mogy
酗	hrjr
擤	hxlw
昶	slpw
郦	idex
驽	orcb
俦	sysh
逅	fyep
锌	havy
刎	wmts
囿	jgfk
愎	ndoq
鱿	jgtk
痔	eiye
魈	hbwf
栉	einu
猊	odtw
碣	utkw
茴	fauf
闼	lfuk
铤	lxvq
矍	uegs
蜚	xiag
彀	gyet
莆	pruj
砒	pdkm
摁	zmlg
钿	lcvg
褓	nsps
湎	mcdk
畹	wkgo
萋	ydum
幄	wngz
蒯	rrus
诶	zipv
籽	viix
魉	ivwj
飨	hvbs
樨	hdnz
绶	dybr
獐	elty
痍	jdym
姹	sfco
辔	pvbf
辔	pibf
厩	ugkz
剜	wkos
镫	kovv
殁	mnkt
旃	ekyq
膻	kkay
荻	kdut
齑	udya
荦	inuq
杓	dsnt
鹘	fugt
笳	ufqc
醮	ubjs
玟	wmhy
漕	csdj
鹗	zjft
胱	gdaf
赝	jckg
驷	tibg
麋	mdyi
懔	iaoy
躅	eufg
骅	febs
伥	slsq
伉	rlsy
雠	sysp
孱	skzx
鹜	wuvt
蛎	idgk
凫	xutt
稔	amqs
讵	urpm
鄱	pnrx
陲	saxq
圻	jaee
馗	rati
壅	jsye
岷	magz
藜	iduq
徕	izel
氯	iuqz
徉	jvei
秣	mnqh
拮	utle
镁	mvvi
镁	mivi
遒	ygip
荏	amus
俳	pzsa
庾	jryw
蚨	xugh
竽	jrqh
囹	ixfs
踯	eifi
蓿	hruo
狒	xitz
偈	udsw
骞	ycob
蔫	ocuj
墒	dley
邂	http
逦	idep
悭	ycos
锺	ehvq
锲	ytvh
眇	mbgd
傣	kzsh
挹	jdlf
缦	mkbw
酆	xohx
螫	ejeg
酩	mxjt
鄢	jcjx
嵬	wigw
藓	hcut
阡	ycxq
缟	gsby
痼	guyf
讧	fhpj
潸	dkdn
阆	ilup
鳍	ydtj
箴	emqk
饴	jdtv
噱	hefa
罹	idgo
茔	jxue
泫	hwdy
椁	gnny
崴	wpgk
蜍	sugs
篁	fdqw
暝	mxwp
酊	kxjj
砧	emka
濮	prds
铣	hcvq
徜	slef
彧	jrmf
颢	fswk
邙	mlyx
栾	iwyn
岬	ufgg
傕	yesp
闱	wiuh
铰	ubvy
栀	eine
舢	dkeg
寮	ibok
跆	lzfv
挝	eelj
裾	urpz
酡	lnjo
毂	guet
珩	fohe
恽	jqop
惇	kqoo
澧	iddg
钤	ycvs
繇	jbrt
祉	eipa
仟	ycsq
帔	pvgc
帔	pigc
镞	vuvy
阍	fqut
珣	hqht
氨	zkqo
黧	idqg
矾	xkkt
铉	hwvy
骓	eabs
枰	pxnl
牝	paqt
蝈	gngf
瞽	gueg
胺	zkao
淦	gkdv
阚	rkuz
奘	vlxk
佶	udse
祛	yrpe
颛	ewgk
痂	ufyc
貉	fjrt
觯	eiti
寤	wuox
殚	kkki
佰	nzsk
轸	emms
猗	jdtk
蒺	uduy
谌	smpj
鸱	sitt
眬	ihgk
禛	empj
鳏	gwtg
拊	xuls
沆	fldy
镐	gsvy
侗	khsg
岈	jfgm
滦	iwdy
擘	nnzl
嫒	zpcr
砦	epak
涪	xudy
遴	iaip
舛	swtm
玕	gkhh
狻	twtv
砭	nckr
愆	ycep
啁	eyft
烊	jvii
撸	irlt
嬛	fwcg
蚝	fsgq
锉	cnvs
臬	otwn
谔	zjpf
韪	wiwh
箐	yxqh
雒	ints
肓	fdya
韫	jqhw
垩	zjje
嫫	mncu
羸	iiyf
霰	hclj
醴	idjg
疽	uryg
娩	mcct
鬣	itjb
叁	tkvk
猕	mdtz
跖	eifk
衩	sfpv
薨	fhuk
菟	lrut
葳	wiuk
绻	ywbi
酶	mvjq
酶	mijq
焘	ksho
潍	widb
氮	kkqi
鬻	jrze
癣	hwyt
牦	msqq
仨	tfsh
豸	eiru
睾	gswe
赍	udjg
舄	hdwt
俅	ygsj
膑	naao
莜	jgus
蚋	aagg
聃	kkjg
玠	uths
猡	intg
陟	eixa
汞	ghjd
邳	pdkx
蠃	inyf
龅	nsat
戗	yvsm
箓	irqz
擢	enlv
搦	onlz
钾	ufvg
螟	mxgp
辚	iami
骢	chbw
辂	irmt
肛	glaj
砝	xjke
砝	xfke
亳	nnyq
蛭	eigm
綦	ydjb
搴	ycol
蔺	iauu
搠	dnli
铱	jdvy
赅	gpgy
荥	jxud
鞅	jvjg
龈	jaaz
氐	kdto
祜	fupj
煅	kwiw
仝	lhsj
瘌	ifyj
坨	lneo
圩	wieh
犟	uvzq
柙	hfng
怫	xuoz
崧	thgn
衿	uaps
昴	mswt
殄	lcks
槿	uanj
噹	klsf
掴	gnlf
莒	uruf
甯	oxop
缱	ycbg
鎏	igdv
醐	fujj
钙	gpvj
淤	jrdy
醍	ldjw
虢	gnra
錾	vkmv
衽	ampq
菏	fjud
馏	igtt
灞	nfdl
搧	dklm
薏	jduy
碘	kckg
苒	akug
缁	vibb
炘	haie
獬	httt
狯	rrts
痿	wiyq
苫	dkua
酢	vnjq
廪	iayy
嶷	jdgt
郧	jqfx
脶	inaf
蜇	ejlg
蘧	yrua
碇	kxko
晷	gawt
嵯	cngi
笄	udqh
兕	tigt
欷	hdrt
歙	djst
嚯	fnfl
舸	gjee
槊	dnin
碜	smkv
瘀	jryy
耒	iiho
锗	ejvj
骝	igbt
砣	lnko
炔	yeiz
猱	ostv
糅	ayiv
貅	hgrs
溧	iddj
犴	zkth
訇	fhty
郏	uflx
螯	zshg
铙	osvm
掾	jwlb
仵	wusq
嚭	pdek
乜	mtba
蝮	xugq
珉	mahz
屌	kbzf
峤	ubgq
铬	gjvt
蕨	ueuk
貔	pdrw
糨	uviz
赉	izlg
镛	jsvy
腩	okaj
砀	klkc
铩	dfvr
薜	nduz
颙	jxgk
缃	hvbn
狴	ndtm
烷	wkio
蝾	ahgu
爻	jbrr
抻	smlg
裎	sopf
吋	cqfk
蓼	ibuv
黢	yrgv
狍	pstt
滁	sudx
烃	lxiv
呙	gnfg
璺	wmwh
耋	ktjm
痫	hcyu
镏	igvt
祆	hcph
轾	eimm
欸	zpvt
芩	yaus
珐	xjhe
珐	xfhe
鼬	jgwg
墉	jsey
筮	diqj
窣	tuoy
窸	hdor
铧	fevs
貊	mnrk
畲	djsg
椋	ivny
鸮	hbft
幷	nxqq
妊	amcq
疥	utys
楸	ygnq
珲	fqhp
纥	fjbq
窳	jroe
煲	nssi
钨	wuvt
郓	jqpx
灏	fsdw
蓍	diuj
硭	mlku
珪	gahe
絷	eilb
镝	kdvy
婺	wuvc
邴	nxjx
璟	uxhw
驺	vybt
鳕	hetl
訾	viay
疡	jvyc
烯	hdir
靺	mnkh
洙	eudq
鲧	gqtt
偾	xmsj
黩	krgj
孢	nsxt
媸	sicx
鞨	fjkw
蟊	msvg
缛	aubk
泖	msdt
轱	gumj
旯	ifwt
锜	ydvk
嘬	vnfw
纛	kshg
褫	sipe
妁	dnct
迓	jfmp
虺	fakg
谶	smps
墀	siez
祧	lbpr
闫	jcuh
姮	foce
蚺	akgg
獾	fwtu
郗	hdrx
鼹	jcww
椤	inng
矞	uevg
柞	vnnq
讬	lnpq
锴	rpvm
岿	ragd
菀	jquo
晗	fkws
茕	ysua
喆	ejee
荇	hxue
笮	vnqq
胪	iraa
昇	dowk
鞬	uckz
傈	idsj
巯	ygvy
鲽	kttj
曌	eswo
猁	idtq
钲	eovj
埙	hqef
嗞	vifi
铆	msvt
哙	rrfs
炻	diik
逑	ygjp
跹	hcfq
铂	nnvw
徭	jber
邛	ysjx
猞	djts
铖	sovk
佺	ywss
蓐	auuk
貘	mnru
凼	kldx
稹	emqj
鋆	jqev
镗	llvf
疋	duxo
倥	rhso
涞	izdl
孛	nvjx
孛	nijx
杲	gswn
钎	ycvq
蜉	xugr
棻	xmun
栎	idnt
脔	iwyg
缳	fwbg
锝	kevw
蕤	aauk
洌	itdk
螈	jwgk
荜	ndum
炆	wmiy
镍	otvw
瘙	tsyv
旻	mawy
莳	diuw
炅	uswi
鹬	jrvt
氦	fpqy
锒	ilvp
湟	fddw
郅	eimx
堞	ktej
暾	lqwy
鼐	ozcg
鲟	hqtz
炝	yvis
偬	vhst
硌	gjkt
咴	fafk
邰	lzvx
竦	thyj
苌	sluq
昺	nxwj
鳃	tptg
腱	ucaz
娠	dmck
侔	mysv
眙	sigv
尜	gfdk
蝰	ragk
鼋	jwhf
瞵	iagi
腚	kxao
洹	fwde
椴	kwnw
镊	otvj
趺	xufh
庹	lnyz
犍	ucqz
盱	hrgh
珥	zihj
杌	wunk
峄	jdgv
伈	hasp
镙	invg
撄	jxlg
吡	pdfm
鏊	zshv
鼍	lnff
馐	hgti
荛	asum
昃	vjwk
娈	iwyc
蹼	prfs
蟥	fdgj
旄	msyq
殳	dutv
擀	gklj
犰	ygtt
雱	pllk
裢	icpm
踟	sifq
焖	mwiu
厣	jckg
鞡	ifkl
锰	movx
瘐	jryw
璁	chhw
吽	fhfq
黟	jdgt
瘿	jxyg
腭	zjaf
骐	ydbj
芨	udut
捭	nzlw
妣	ndcm
酃	ixlx
苡	jduv
稞	rjqg
蛉	ixgs
瑷	zphr
勐	moxc
戡	rkjm
澍	dude
雩	jrlh
沨	xodt
骘	eixb
憷	suon
诜	dmpq
筅	hcqq
郿	mvxx
郿	mixx
陂	pdxc
襦	aupl
郇	hqtx
垭	jfej
檫	sfno
飏	jvtv
邗	fkhx
垓	gpey
謇	ucoy
佤	wfsm
苕	lbuc
蝓	jrgs
氟	xuqz
煸	ncip
鲑	gate
沔	mcdj
酮	lhjg
樘	llnf
蜊	idgq
鲵	odtw
刭	uxvs
蕈	hquj
堠	fyes
鄯	dkix
愀	yboq
纮	fhbk
氰	yxqh
鳟	vqti
瓤	alye
鲰	vytj
瀣	htda
肜	ahae
钯	nfvx
褰	ycoy
陉	hxxv
坩	gkej
笫	viqt
渑	dodf
裣	icps
阄	ugut
缗	mabz
跶	kffk
疱	psyt
玦	uehz
罴	pdge
尻	rszt
燹	hcki
艏	dyei
眭	gage
肏	csrg
孳	viix
樯	yvnj
旒	igyq
氖	ozqc
鲶	octs
珮	pvht
珮	piht
枋	xlny
蒹	ucui
泶	heod
怛	kfow
忉	ksoc
桁	fone
淝	xida
萑	fwus
榉	urno
鲈	irta
蝣	jggy
〇	ixaa
栳	isnj
蚍	pdgm
殍	pbkr
埚	gnef
麂	udyt
矬	cnqs
谰	ikpu
趸	kqmf
縻	mdyb
艨	moeu
瓴	ixsm
勰	htcg
佧	rfsa
蹚	llff
侪	spsy
桫	tnnd
翥	eujv
喱	idfk
漯	indg
鲠	gotj
枸	gynt
笤	lbqc
焓	fkis
磻	pkkr
洄	fadf
跗	xufs
雎	urgs
鹕	fujt
篦	ndqw
窨	jaoy
邽	gaex
昉	xlwy
阋	hduw
馕	oltj
镪	yvvz
疴	rjye
颎	ustk
鹈	ldit
艟	shey
跸	ndfm
砬	idky
濉	tadg
锍	igvy
埘	diew
逄	pltp
萘	ozuk
蝥	msvg
蚧	utgs
塄	ioeg
剡	jcis
荠	yduy
鼙	pdew
彖	lwbk
趿	lfft
郯	lkix
暐	wiwg
鲇	octa
蚜	jfgm
伷	eysg
璆	yghv
稗	nzqw
赟	jqyg
矸	gkkh
闿	rpyg
扦	yclq
睃	tngv
菔	xuua
觋	hdjg
蟛	poge
枥	idnk
轳	irma
哚	knft
醪	isjv
蚰	jggg
囟	hawr
蛄	gugj
狳	jrts
倬	ensa
锱	vivb
嗉	tufh
鋈	wudv
鳐	jbtr
谘	vipy
侑	jgsk
毖	ndmp
曈	lhwy
潆	jxdu
嬗	dkcy
耔	vihx
鞒	ybjq
渌	irdz
锑	ldvi
禳	alpy
锕	zfvx
辊	gqmw
昽	ihwk
芪	ydut
茇	nfuk
疣	jgyk
耪	plhy
榫	tqns
孥	orcx
蛩	ysjg
萁	yduj
酽	jcjj
薅	fsuc
龃	urag
莰	rkue
蜞	ydgj
罨	jcgk
崤	hbgr
氪	rjqj
芫	jcuh
镕	ahvo
毽	ucqz
铋	ndvp
捌	nflf
觚	gute
鲀	lqtm
嫜	elcy
砷	dmkg
茌	sius
刖	jeas
骶	kdgt
穑	tjqj
螽	ehtg
鹚	ciit
糁	tkiv
缒	eabw
戽	fupo
滹	fuda
攮	ollj
愍	mazp
瞋	smgk
囝	ucfx
髋	rwgo
坭	odez
艉	wiez
飧	tqts
鲂	xlty
嵊	dogq
殂	cukg
橛	uenk
匏	pskt
澶	skdy
絜	hthb
蠼	yrgg
鞯	ucju
冱	fuym
痈	jsyt
蹓	igft
樗	sunl
椟	krnj
尕	gfcd
垸	jweo
辌	ivmy
岙	zsqg
龉	jraj
髡	rqjk
髁	rjgg
缯	vobi
蔌	tuuj
鹾	cnai
芰	uduj
椐	urnz
瓠	fuke
皲	uqpc
橼	jwnb
帑	llcg
彘	eibq
龁	fjaq
隈	wixg
圹	rdey
锞	rjvg
龋	yraw
鸹	geqt
垱	klef
筚	ndqm
榖	guet
暌	rawv
赜	vjjh
泔	gkdj
餍	jcks
芾	xiuj
醯	hdjy
蹁	pcfp
鸬	irat
朐	sqat
蚬	hcgg
甑	voim
嘡	llff
蓖	nduw
绂	xubk
奭	dikk
螅	hdgw
芎	hsuz
铗	ufvl
摭	eily
亶	kkyg
柟	okng
髫	lbjw
膣	eiao
宄	gaot
晞	hdwk
沉	smdp
鍪	myvv
妫	gaci
骟	dkbp
圯	jdez
棰	sanq
柁	knno
礅	kqky
钡	nvvg
钡	nivg
盍	fjeg
硼	poka
秫	duqn
熘	igit
耨	oyhk
鞣	ayjv
敉	mdiq
袆	faph
膈	gjae
缡	idby
飑	nbtt
脘	wkao
栌	irna
郴	smnx
涑	tudj
袪	yrpe
醚	mdji
钪	rlvy
瘆	dmyv
箜	rhqo
酎	eyjj
肄	jdtz
跏	uffc
栊	ihnk
柒	yddn
鲳	sltw
痱	xiya
蛳	tigd
龢	fjsq
秭	viqt
谵	ekpt
暼	ptfw
笥	tiqz
蟮	dkgi
堀	ruez
阏	jcuy
氚	swqw
穰	alqy
祎	jdph
枵	hbnf
镆	mnvu
焐	wuij
皴	cqvc
捩	itlp
绐	kzbv
邡	xlyx
幪	mogu
苎	euuo
蒌	iyui
闶	rluy
圮	pdez
菖	sluw
粳	uxij
儋	kkst
眚	doqg
鳓	ietj
庑	wuyh
廨	htyt
瓿	nrym
怙	fuoj
徼	ubew
芴	wuut
柽	sonv
觳	fuet
钭	kvvo
钭	kyvo
蓊	wour
黥	yxgy
酰	hcjq
豨	hdkr
莨	ivup
琯	gwho
僳	tusj
硒	hdkj
捽	vnly
愦	raog
俣	jrsf
玡	jfhm
曛	hqwq
卮	eieb
揎	hwlo
曩	olwy
喾	ruoq
袢	pkpi
魆	hrwm
笊	esqe
馑	uatj
芏	krue
珅	dmhg
秾	ohqp
榧	xinm
鲷	kbtt
蘖	otuw
莴	wnuf
鹣	ucit
倧	vhso
桡	asnm
蕖	yrud
汊	sfdv
仂	iesc
旆	pvyq
旆	piyq
钣	nkve
蘼	mduy
阇	kruk
坶	mreb
卺	uaxb
蕞	vauw
沤	zydm
焗	uriz
垆	irea
嫠	idhk
屣	hdze
镒	jdvi
鸰	ixst
蛑	mygv
鼗	lsre
鳔	nbtj
锆	gsvq
藿	fnul
缶	xyqi
浜	nldw
铴	llvd
蓥	jxuv
詈	idgy
怃	wuoh
麈	euyy
蛞	rngq
钚	nrvk
癔	jdyy
鲆	pxtl
鄣	elyx
酲	sojf
骖	ckbv
痦	wuyj
溽	audk
抔	pylk
黻	xusk
鹩	ibkt
蜣	yvgi
揸	efln
谝	pcpp
碛	ydkh
缂	rjbj
塬	jwek
赀	viag
玘	ydhz
笸	pnqm
檩	iany
趵	nsft
猓	gntg
燔	xkir
锊	ijvr
璠	xkhr
揠	jflm
蕺	uduf
伛	jrsm
孓	uexo
昝	vktw
珰	klhf
阊	sluw
旸	jvwc
鄄	uwjx
岘	hcgg
镧	ikvu
溱	emdh
碚	nvky
碚	niky
胙	vnaq
焜	rqiw
璘	iahi
萏	kkut
烜	hwie
铍	pdvc
芑	yduz
糌	vkit
幞	xugs
啫	ejfk
隹	easy
缬	htbe
镟	hwvy
崃	izgl
戢	udfj
坼	sjee
硎	hxkh
邶	nvax
邶	niax
伲	odsz
坫	kcea
铊	lfvo
箪	kkqi
菽	duua
篪	siqe
槠	eunp
獴	motu
鳎	lftw
钒	xkvt
筌	ywqs
荨	hquz
诼	enpk
廑	uayj
敫	ubwq
磙	gqky
豉	siej
髀	ndgw
锛	nwvk
辏	cymh
胝	eiat
碹	hwko
酯	eijt
甏	noem
檗	nnzn
厍	djkm
圬	wueh
苣	urum
僰	nnks
颞	otjk
嗍	tnfi
鲢	ictm
癜	kcyz
瞢	moug
哕	fafg
诹	vypj
忭	ncoy
坻	kdet
卣	jgaf
蛱	ufgl
猇	hbta
熳	mkiw
轫	ammc
氘	ksqw
缌	tibg
槲	funt
椹	emnj
郾	jcjx
锂	idvg
菑	viug
耩	uvhh
鞫	urjt
麸	xuhh
铟	javf
茈	viua
嘏	gujz
锘	onvu
阌	wmur
琤	soht
砩	xukz
裉	rmpz
瘰	inyg
黾	mafg
璩	yrha
薹	lzue
堙	jaej
胗	emas
杩	mfnb
刳	ruks
缫	tsbb
狺	jaty
狨	ahtm
圪	gjeq
嗾	tyfy
铯	tjvt
缍	knbq
麇	yqyq
砗	sjkm
悝	idog
羝	kdit
尥	ibkt
顸	fkhk
痤	cnys
髎	ibgv
饫	jrtq
鹋	mbut
槭	ydnk
腧	duas
蘩	xkuq
颟	mkuk
镢	uevk
蠓	mogu
郐	rrsx
嵛	jrgs
绲	gqbw
踬	eife
唛	mzfh
隳	faxs
赓	goyg
溻	lfdw
翮	fjev
眄	mcgj
缧	iibg
酹	iijr
糍	ciii
垲	rpeg
湉	lcdo
嬖	ndzc
馓	tktj
萸	jruw
畚	nwvk
刈	jdrs
旰	gkwh
跣	hcfq
鞲	gyjh
鹀	wukt
蚴	jggb
帻	vjgh
醢	fpjk
疸	kkyw
硖	hfkl
瘳	syyv
蠲	uwig
鲞	hvit
荭	fhub
龠	jesf
颃	flyk
胼	pcai
嵴	udgy
牂	vlxi
呒	xufh
峁	msgt
铒	zivj
仉	elst
仡	jdsq
鄞	jajx
颡	tlvk
侉	resk
疔	kxyj
桄	gdnf
栝	genq
痧	dfyd
芘	pdum
瘘	iyyi
绨	ldbi
鸲	yrtt
謦	yxjy
屦	urze
嗌	jdfi
葸	hdug
辒	wmmw
粝	idik
篌	fyqs
踔	snfa
葑	xoue
耧	iyhi
酾	dije
梃	lxnq
裰	knpv
褟	lfpw
皤	pnwr
虿	spmg
廛	skyg
鸤	dizt
泮	pkdi
鲋	xuts
掭	lclh
凇	thyn
枧	ucng
胍	geae
醑	hrjx
臜	vfaq
陧	otxw
燠	jriw
缣	ucbi
蹀	ktfj
镋	llvf
谖	hwpr
嗪	yafh
畈	xkge
簟	kcqj
谇	tapy
谳	jcpj
莼	squb
舻	irea
铘	jtvm
鲮	ixte
慊	ycoi
趑	viey
贶	rdgf
僬	ubss
菹	vuud
垧	dlew
梿	icnm
锩	uwvi
蝤	yggi
吣	yafp
垅	ihek
藁	gsuy
龀	smat
邾	euqx
蒴	dnui
庋	gayj
琫	nohh
鬲	idef
锬	lkvi
醅	pvjy
醅	pijy
酐	gkjh
笕	ucqg
诖	gepe
轭	zjmk
醛	ywju
肭	ofag
陴	pdxw
鹮	fwgt
硷	ucks
峣	jbgm
剞	udks
胲	fpay
鸸	zikt
搿	gjqs
疝	dkyg
菰	guux
埸	jdew
冏	usgr
嬲	obgc
鲔	witk
悛	ywov
愔	jaoy
柝	lnne
劂	ueks
蚵	rjge
劬	yrtc
黹	eisi
钼	mrvg
桴	xunr
鬏	ugjq
艋	moex
躜	vwfq
硪	wnkq
肽	lzak
鳊	nctp
礞	moku
榇	smny
舯	eheg
箅	ndqg
埵	kneq
獯	hqtq
鹨	igvt
媵	jxai
髂	yfgo
呋	xufh
嫘	iicg
麹	yrht
觫	tutj
潲	dsdq
碲	kdky
楝	icnj
绱	dlbf
洚	uvdt
垤	ktem
鲱	xita
绀	gkbj
磲	yrkd
墁	mkew
趱	vkeq
甍	moum
鲥	ditw
谠	klpf
埕	soef
隰	hdxw
辋	wlmg
鬯	slrt
髌	nago
砜	xokt
牁	rjxk
锶	tivg
崮	gugf
岵	fugj
罟	gugj
铵	zkvo
慝	lehp
俶	susa
毹	dusq
刿	gags
骱	utgs
啶	kxfo
鹆	jrrt
搛	ucli
窭	uroi
蚶	fkgj
郄	ytrx
谮	vmpm
饩	hdtq
俜	pxsg
砘	kqkm
绋	xubz
馡	xiqa
锳	jxvu
溷	fqdf
枘	aang
浯	wudj
崦	jcgk
笪	kfqw
酚	xmjr
劓	jdws
蒽	zmug
渖	dmdo
逯	irzp
屺	ydgz
毵	tkvq
齁	fywt
舨	nkee
胬	orcg
蛏	sogv
汆	cwrd
锾	fwvr
氽	lqsd
亓	ydhw
羑	jgit
芟	dkut
挢	ublq
岣	gygt
瘵	epyt
蓣	jruv
诎	yrpx
粜	lbxi
蔸	kvuw
蔸	kyuw
镡	havj
銎	ysjv
怿	jdov
鲎	fyot
鐾	nvzv
鐾	nizv
甙	kzmj
芄	wkut
肟	wnah
羼	skzi
躞	htfy
拶	vflb
鹍	rqwt
汔	yddq
蠖	fngu
骀	lzbv
醣	lljy
舾	hdej
觖	uetz
蝻	okgj
蛴	ydgy
腽	wfaw
氆	prqi
鳜	gatk
塍	soai
庥	hgys
莸	jgut
撙	vqli
嵫	vigi
篼	kvqw
篼	kyqw
褊	ncpp
劢	mzmc
跬	rafe
擐	fwlg
嘧	mdfo
氇	irqt
庀	pdyt
箦	vjqh
蛲	osgm
荽	taur
肷	ycat
肼	uxah
蒉	raug
缑	gybs
遘	gyhp
鲭	yxth
锸	sfvq
舳	eueg
倮	insg
縠	fuet
袷	ufps
蠛	mtgu
孖	vixx
笱	gyqt
硗	ybkm
埽	tsez
袼	gjpt
鱽	kstc
杪	mbnd
芈	mdah
簋	gaqz
戆	glyp
滏	xudr
黼	xusj
鞔	mkjt
臁	icay
瘗	jdyl
酴	lrjs
阃	rquf
扃	uspg
浼	mvdt
浼	midt
篥	idqj
鹪	ubst
礌	iikl
黪	ckgv
跫	ysjf
裥	ucpu
氡	khqt
耜	tihg
黉	fhoj
胂	dmag
垌	lheg
斝	uffo
榘	urqn
澌	tidj
欻	hrit
肫	eqam
钸	nrvk
禊	hdph
锼	tyvw
鳆	xutq
钋	pnvf
秕	ndqm
佴	zisj
氩	jfqj
籼	hcig
綮	yxpb
楯	kqne
砻	ihkk
砟	efkq
炱	lzvi
躐	itfb
苤	ptuk
犋	urqg
钌	ibvx
儇	hwsg
鼯	wuwj
弢	lszg
榀	panf
髑	krgg
逭	fwop
煺	laiz
疃	lwgy
踣	nnfy
龆	lbac
曚	mowu
蛸	hbgf
湲	jwdr
觇	skag
徂	cueg
畀	ndgk
簏	irqy
坜	idek
螨	mkgu
蝽	sqgh
迕	wuqp
桷	uent
硐	khkg
楦	hwno
镱	jdvy
瘅	kkyi
埤	pdew
澔	fsdw
钫	xlvy
镘	mkvw
畛	emgs
锪	fnvt
蟪	fagj
氙	hcqg
铈	divy
叆	zphr
砹	zpku
锇	zjvq
媭	hrek
沲	lndq
嶓	nngr
跐	cifa
碡	eykh
擗	pdlz
镉	idve
眢	jwtg
菪	kluo
虼	gjgq
穸	hdot
缵	vwbq
巉	skgt
鹁	nnjt
岜	nfgx
陬	vyxj
蛘	jvgi
腠	cyah
蹽	ibfk
烀	fuir
膦	iaai
锔	urvz
畋	lcgq
筇	ysqj
罽	udgk
搌	eklz
葶	lxuy
霪	jald
埴	eiej
莩	pbur
葚	dmuj
疬	idyk
胩	rfaa
胨	kham
稂	ilqp
崚	ioge
髟	nbje
骒	rjbg
潴	eudt
籴	kdri
蒇	skuk
揲	ktlj
窀	eqom
冁	skiz
裒	pyyw
虮	udgt
晡	nrwj
罱	ikgj
镦	kavy
鲦	lbtt
悃	rqof
浥	jddf
髹	hgjs
埝	oces
铚	eivm
苈	iduk
羟	yviv
谂	dmps
锿	zpvy
攉	fnll
轺	jbmc
榱	cany
靸	tfkt
邠	narx
噍	ubfs
薷	auul
舴	vjeq
诔	iiph
垕	fyef
淠	pddg
砑	jfkm
铥	kgvq
钕	ouvc
蠋	eugg
榍	htnz
罘	xugk
倕	sasq
镓	ufvo
羰	llig
帙	eigq
鹱	futu
鹖	fjwt
襞	ndzy
疳	gkyj
莛	lxuq
墼	udje
槔	gsnw
弪	uxzv
鸫	khmt
鲡	idte
爨	cwwn
钔	mwvu
鳇	fdtw
嚄	znfu
裼	hdpw
悫	yeep
钍	lrve
氍	yrgq
腈	uxah
嵎	jrgg
颥	aulk
苄	ncuy
拃	eflq
鳙	jsty
聍	oxjo
臑	osal
澉	gkdz
鹔	tuzt
鲼	xmtj
舁	jrwk
饔	jsys
珧	jbhr
艚	csej
赙	xugj
眊	msgq
骺	fyge
荸	nduj
镮	fwvg
跽	udfz
鲖	lhtg
酞	lzjk
畎	ywgk
殪	jdke
镎	ofvs
鸻	foet
瓘	gwhu
坌	nwre
饹	ievt
硇	oskw
钐	dkve
掯	rmla
瘊	fyys
牤	mlqy
鄹	vyjx
瀹	jeds
疖	utyx
鹇	hcut
舡	swej
褙	nvpa
褙	nipa
锖	yvvh
牾	wuqj
惙	snov
籀	eyql
埒	iter
桊	uwin
觌	kdjg
矧	dmqz
蜱	pdgw
桕	ugnw
豇	uvej
唼	dffy
筘	ryql
镅	mvvx
镅	mivx
骣	skbz
郫	pdwx
镄	xivz
伭	hcsy
鞴	nvjj
鞴	nijj
镨	prvi
恝	ufhp
侂	lnsy
羧	tniv
锽	fdvw
椠	ycmn
骎	yabz
檞	utnt
窬	jros
埯	zkek
醵	urja
瘕	ufyz
俵	nbsh
铌	odvz
蓰	hdue
窆	ncor
沚	eida
瘛	siyh
鲌	nftw
鲗	vitg
捯	kslm
憝	kayp
蟓	hvgt
砉	hrhk
尪	wlkh
瘼	mnyu
礤	cfku
祓	xupk
搋	srle
哳	effl
鳘	maqt
鲅	nftk
聱	zshj
艽	ubut
戋	ucho
鳈	ywtw
惝	slof
钆	gfva
葜	yfuh
氕	ptqu
綄	wkbo
迮	vjqp
铷	auvc
粞	hdij
鸺	hgsn
铕	jgvk
驵	vlbg
鲒	utte
脬	psar
瞍	tygw
缲	tsbf
埏	jcew
堍	lret
礓	uvke
伾	pdsk
赆	uagz
罥	uwgf
绠	gobj
鳢	idtg
捃	uqlz
箨	lnql
篚	xiqm
跂	ydfk
髃	jrgg
脒	mdai
慭	jalp
埭	kzez
砼	lhks
橥	eutn
鲩	fwto
桤	ydng
栴	eknq
叇	kzhz
锧	eive
轹	idmt
滠	djdj
鲐	lztv
夬	grzo
饸	fjts
猸	mvtx
猸	mitx
赒	eygt
弿	ucoz
蕹	wouy
甾	vpbg
谿	hdrr
跓	eufy
庳	nvyw
庳	niyw
挦	hclz
鹴	ddlt
谞	hrpx
狝	hctt
罾	vogi
筲	dsqf
蹯	xkfr
脎	tfar
揞	zkly
耱	mnhy
廒	zsyh
爝	ueir
濞	pddw
讻	hspr
鸼	eyet
铫	jbvr
镤	prvs
瘃	euyk
塥	gjee
锎	rpvu
劐	fnus
鹐	yctt
鲣	ucts
觱	ndkt
涠	widf
鹙	ygqt
飗	igtt
嚆	fsfu
鲻	vitb
馇	sftn
鹛	mvxt
鹛	mixt
耵	kxjj
揳	htlh
甓	pdzm
鲚	udty
钶	rjve
瞀	msvg
痄	efyq
姶	zjcs
蕻	fhuj
怊	ssoc
癀	fdyj
粿	gnig
阼	vnxq
脞	cnas
钇	jdva
蒟	uruy
嶝	kogv
衄	ouwx
崟	jagv
趼	ucfh
杻	ognx
谫	ucpi
蒡	nluy
憺	kkot
舣	jdei
饳	kntx
鳒	ucti
砮	orck
鲃	nftx
猹	sftn
箢	wkqo
膪	sray
馘	gnim
亸	knyi
鲊	eftq
纴	ambq
镥	irvt
癃	ihyx
簖	kwqi
痃	hwyy
镩	cwvo
芼	msuq
崞	gngy
诪	eyph
躔	skfy
薤	htuk
耥	llhf
饾	kvte
饾	kyte
亹	wiyg
瞫	dmgj
侁	dmsq
毪	mrqv
醭	nrjs
稃	xuqr
诐	ndpc
阢	wuxk
铼	izvl
郛	xurx
眍	rygm
摅	dula
鳑	plty
嵖	sfgn
馉	gutg
蹾	kqfy
绖	ktbm
鼽	ygwt
勔	mckc
辀	eyme
苠	mauz
眵	sigt
枨	sonq
奓	djkt
軎	wijf
鲺	dita
牿	guqq
缏	pcbs
筢	pfql
垡	xjse
垡	xfse
靿	jbjb
舭	ndem
鹎	nvwt
鹎	niwt
鳣	ekty
螬	csgj
溍	uadj
贳	dijg
藠	ubuw
镴	ifvb
岍	ycgh
缋	fabg
腙	vhao
牮	ucsq
酤	gujj
翚	favm
鼷	hdwr
両	ivki
泐	iedx
褃	rmpa
豀	hdrr
螗	llgy
铹	isvu
熜	chiw
磉	tlkv
莶	hcus
铦	hcvq
铓	mlvu
蒎	pzud
鹡	udyt
螵	pbgj
澐	jqdl
鳀	ldtw
钖	jvvc
邿	diex
璈	zshh
垴	osey
獏	mntu
锫	pvvy
锫	pivy
趹	uefz
钷	pnvm
脲	obaz
碶	ydkh
镠	igvv
邨	cqmx
疰	euyy
邲	ndpx
玭	pahm
鸧	clst
撖	fklz
踒	wnfq
墚	ived
馝	ndqp
劁	ybss
犏	pcqp
馃	gntg
滗	nddq
仫	mrst
蜾	gngg
馌	jtte
痖	jfyj
阽	kcxa
瘥	cnyi
於	jrys
禧	hdpe
嘟	krfj
叨	ksfc
拚	palv
噜	irft
妞	ogcx
娴	hccu
嗨	fifd
嘀	kdfy
沌	kqdm
渎	krdj
徙	hdea
呱	gefe
嗒	kffu
腓	xiaa
吆	jbfb
囱	chwt
剌	ifjs
哝	ohfp
阪	nkxe
劾	fjyc
胥	hrxa
哧	sife
悻	hxoe
憬	uxow
哽	gofj
瘢	nkye
沓	lfdw
涟	icdm
恻	cjog
寰	fwog
唷	jnfy
恣	viyp
町	kxgj
淇	yddj
瓒	vkhq
谥	dipi
涓	uwdf
湮	jcdj
岖	yrgm
呷	hffg
啾	ugfq
嗫	otfj
嗬	fjfu
疟	ojym
洵	hqdt
咂	vffm
喏	onfu
噤	uafn
匍	prtj
沅	jwdh
骰	lvgt
骰	lygt
裨	ndpw
祐	jgpk
噼	pdfz
瞭	ibgk
咻	hgfs
唑	vnfs
宸	smok
簦	koqv
槁	gsny
唏	hdfr
芷	eiua
唰	defz
苷	gkuj
枞	chns
嘁	ydfk
苻	xuus
媾	gych
僮	lhsy
雉	eiqs
艮	gmzo
濡	audl
夥	fngt
婀	zjcx
怵	suon
殒	jqkf
崂	isgu
嗑	rjfe
噙	yafs
淅	hddn
獠	ibtk
锨	hcve
壹	jdee
竑	fhyk
抟	lwlh
艿	ozuc
妍	jcch
苁	chus
嗲	kffr
揄	jrls
咤	effo
嗵	lhfv
怼	kavp
茯	xuus
茏	ihuk
咩	mtfi
囡	okfc
楂	efnn
樾	jene
钴	guvj
忸	ogox
绌	subx
薮	tyui
厝	cnkj
莅	idus
嶂	elgy
浔	hqdz
渚	eudj
耦	zyhg
篾	mtqg
邈	mbrp
隗	wixw
匦	gamm
泷	ihdk
茑	obut
逡	yqvp
溴	hgdw
啭	ewfm
饧	hxtc
杼	eunv
濠	fsdy
嗄	zffk
嘣	nofg
夤	jato
涫	gwdo
祇	ydpt
佝	gyst
诂	gupj
逋	nrjp
岢	rjge
汨	mddw
咭	udfe
浠	hddr
呔	kzfk
槎	sfni
舂	shhw
妗	uacs
菸	jcuy
芗	hvub
嘌	pbfj
瓯	zymm
逶	wiqp
芡	ycut
矽	hdkt
卟	nrff
姒	ticv
菅	ucuo
圜	fwfg
莠	jguq
笾	ncqc
囵	iqfs
曷	fjwt
瑭	llhy
纰	pdbm
娉	pxcg
纡	jrbh
郃	fjsx
旮	gftw
跞	idft
堋	poea
枳	einf
蕲	ydui
琮	chho
焱	jcii
溆	hrds
碓	kaks
崾	jbgj
乇	lnqa
炷	euiy
僦	ugsy
屙	zjzx
圄	jrfj
浞	endf
苴	urug
滟	jcdh
泠	ixds
哞	myfv
洳	audc
芤	ryux
洮	lsdr
啉	iafn
嫱	yvcj
葎	iuue
嘞	iifj
蘅	foue
焯	ssia
葭	ufuz
喁	jsfg
粢	viyi
哌	pzfe
唿	fuft
鳚	witz
璎	jxhg
冼	hcyq
疠	idym
煳	fuij
汜	tidz
嵝	iygi
莪	zjuq
苊	zjuk
犸	mftb
玢	nahr
噻	tpfo
呖	idfk
篯	ucqv
溘	rjde
朊	awah
悱	xioa
糇	fyis
祕	mdpp
玎	kxhj
湔	ucdi
遄	swgp
戥	kowm
獍	uxty
菘	thun
湓	pwdr
铑	isvj
膂	iuya
哿	gjce
哏	gmfz
镬	fnvu
茭	ubuy
溏	lldy
喹	rafk
姝	ducq
溲	tydw
檠	yxun
锓	yavz
钽	lkvw
瑗	jwhr
檎	yans
渫	htdj
歃	dfqt
哓	hbfm
鳡	gktk
叻	iefc
洇	jadf
吖	zffi
醌	rqjw
岽	khgm
豳	nagk
剀	rpgs
傺	sist
棹	esna
吲	jafz
碥	nckp
蕰	jqud
螋	tygw
祏	dipk
纻	eubo
潋	icds
萆	nduw
沭	dudn
棼	xmnr
柰	oznh
怍	vnoq
襻	pkpn
栲	rsnj
茛	gmuz
翙	fagv
茀	xuuz
珙	ghhj
漶	fwdg
菝	nful
洎	uddw
鬘	mkzw
尢	jgka
绁	htbj
狁	jqtv
佾	jdsr
浍	fads
圉	jrfe
菥	hdun
矻	rukq
鲴	gutf
缞	drby
鄗	fsyx
萜	ltug
脩	hgst
骙	rabv
陔	gpxy
鼩	yrtt
蒗	ilud
掊	pyly
鲏	pdtc
琚	urhz
茆	msut
蓁	emuh
遹	jrvp
忮	eioj
攴	prav
喈	utfm
郤	hdrx
腘	gnaf
龂	jaae
釐	idhk
觏	gyhg
蒐	tyuw
鲿	sltf
钬	fnvi
泺	indt
癍	nkyh
霨	wilz
蜩	lbgt
唣	vsfw
蒨	ycus
恧	oukp
鲕	zitk
夼	rdkw
鞮	kdjw
翛	hbst
纩	rdby
酺	prjj
铪	ffvs
鲉	jgtg
狃	ogtx
霅	efly
洫	hrdw
赕	kkgi
骃	jabg
蔀	nruy
蟫	jagj
靰	wujk
蹐	udfy
胠	yrae
蹅	sffn
萩	yguq
訄	ygty
籥	jeqs
茼	lhug
洧	widk
铏	hxvh
骕	tubz
赇	yggj
钘	hxvh
葰	uqus
耖	sshd
魋	laws
阘	lfuw
祼	gwpg
鲙	rrts
鳁	wmtw
鳉	uvty
裈	rqpp
鄚	msux
虒	tiea
镈	nnvj
箖	iaqn
遆	ldyp
麑	odyw
禋	japj
訚	jauy
衒	hwey
罶	iggt
翃	fhkv
轵	eimf
襕	ikpu
鳤	gwtq
糈	hrix
茺	shuy
唪	xofh
硚	ybkq
隃	jrxs
翀	shvg
薿	odut
苾	ndup
舲	ixes
绹	lsbt
鱾	udtz
鲝	efit
鹟	wort
葙	hvun
禘	kdpy
蝘	jcgz
菍	otus
蕗	iruf
仳	pdsm
葴	emuk
镚	novg
猃	hcts
蔟	cuuy
硁	rokv
褯	utpy
踦	ydfk
秬	urqz
楱	cynh
筦	gwqo
鲯	ydtj
鼱	uxwh
菉	iruz
鼢	xmwr
簰	pzqw
蓇	guug
檑	iinl
镲	sfvo
鲹	dmtv
赗	xogg
磜	ydkt
铽	levm
掎	udlk
醨	idjy
螣	loai
鄜	xuyx
觜	vaat
缊	jqbw
陞	doxq
蓠	iduy
鹯	ekyt
哜	udfy
觿	hdtg
馧	jqqw
茝	spuj
薳	wiue
蓏	inue
酂	vkqx
鲪	uqtz
戤	gpcm
薢	htut
毳	caqq
麀	jgyt
轪	kzmk
盦	zksj
铻	wuvj
茚	jaut
沩	widi
筼	jqqf
鄠	fulx
飔	titg
睄	dsgf
鄘	jsyx
铞	kbvf
郪	ydmx
硙	wikg
磡	rkkj
翂	xmvr
耢	ishu
荄	gpuy
苧	oxuo
糵	otui
菂	kduw
帱	sygh
矰	voqi
酦	pnjc
麖	uxyy
邘	jrhx
郈	fyex
翯	fjvy
齄	efwn
苘	yxug
醾	mdjy
柃	ixns
迺	ozjp
鄫	voix
艴	xuzt
芃	pout
碃	yxkh
莿	ciuj
鳛	hdtv
讱	ampc
蓂	mxuw
颋	lxqk
荬	mzua
祋	kapt
瓞	kteq
踺	ucfz
鞧	ygji
镵	skvt
袗	emps
赪	soea
蜐	utge
艎	fdew
蜎	jwgf
筻	glqj
圊	yxfh
韨	xuhk
辁	ywms
縢	loai
飐	ekta
裛	jdyf
黇	lcja
雊	gyts
黡	jckg
隺	fupe
楗	ucnz
诇	hspg
骍	hxby
詟	ejky
漤	ikdn
漭	mldu
蘘	aluy
鼫	diwk
镃	vivi
蒻	anuz
磹	kckj
蔊	fkui
茽	ehus
葖	lruy
藦	mnuy
荖	isuj
趯	ldvj
簕	ieqj
簃	jdqq
觭	udtk
绤	hdbr
祃	mfpb
窊	wfoe
窅	jbog
窎	kbot
祲	uapz
稌	lrqs
鲾	ndte
鳠	futu
跱	eife
鲬	jstv
鳂	witg
稆	iuqf
韂	skjt
鬶	gahj
罍	iigq
耰	jghk
襫	dipk
蚄	xlgy
螠	jdgi
藨	nbuy
萚	lnul
赑	ndgg
蒄	gwup
翾	hwgv
虍	fuam
虤	jcaa
甗	jcam
扂	kcpa
扅	jdpt
扆	jdpy
扊	jcpi
忳	lqom
烶	lxiq
焆	uwif
煓	lwig
煴	jqiw
熇	fjiy
燏	jriv
爚	jeis
宧	jdoj
丌	udki
彐	udze
翈	hfgv
绗	flbe
荮	eyub
禔	eipw
祾	ixpe
禤	hwpg
禚	enpi
缐	hcbw
硔	fhkj
砄	uekz
磏	icki
碨	wikg
碏	yekj
砫	euky
硊	wikt
觟	fete
玚	jvhc
玱	yvhs
玹	hwhy
玼	ciha
珌	ndhp
酏	jdjx
腨	dwag
肸	hdar
脟	itar
脿	nbah
腒	uraz
胈	nfak
朏	xiax
珷	wuhh
珸	wuhj
珺	uqhz
琄	hwhf
琭	irhz
瑂	mvhx
瑂	mihx
瑅	ldhw
瑔	ywhw
瑝	fdhw
瑢	ahho
瑨	uahj
瑱	lchj
璮	lkhy
璲	tahi
瓀	awhl
蔹	icus
斶	sueg
鳋	tstv
饻	hdty
疐	eijg
屃	hdzg
螱	wizg
嶦	ekgt
嶒	cogi
嶍	hdgv
疍	kkxw
谼	fhij
嵅	fkgk
囗	wife
崒	vugy
崌	urgz
峿	wugj
蹜	tufo
踶	kdfw
峗	wigt
岠	urgm
岞	vngq
圌	swfg
屼	wugk
酅	hdgx
瀼	aldy
瀌	nbdy
鹝	jdet
濩	fudu
澴	fwdg
澥	htdt
潏	jrdv
漻	ibdv
漈	uddt
滆	gjde
滃	wodr
湜	didw
湑	hrdx
洈	widt
泚	cida
泃	urdt
泂	usdg
汧	ycdh
虓	hbta
瀵	xmdi
浈	emda
咇	ndfp
咥	hdfm
喤	fdfw
噇	sdfy
耇	gyjt
耠	fnhs
耤	udhj
竘	ryyt
晐	gpwy
晊	eiwm
昫	hrwt
憭	ibok
昣	emws
昡	hwwy
昈	fuwp
旴	hrwh
郚	wujx
敔	jrjq
驲	aibw
弆	urek
糸	mdbd
鲘	fyte
凵	ycxi
惎	udjp
爿	pkxu
嬬	aucl
嬥	lbcv
鄃	dusx
嫽	ibck
嫪	iscv
媞	ldcw
媖	jxcu
媓	fdcw
徛	udek
舠	ksec
艅	jres
舥	pfex
衠	eqej
衎	rkeh
媂	kdcy
婫	rqcw
婤	eyct
婍	ydck
姽	gact
姤	gyce
妭	nfck
枅	udnh
梌	lrns
梠	iunf
梾	iznl
歅	jajt
棤	yenj
棽	smns
椆	synt
鄑	vijx
楙	msnv
羕	jvip
勠	irvc
榃	lkng
榅	wmnw
榑	xunj
戣	ravm
羖	guit
橑	ibnk
橦	lhny
睎	hdgr
痓	eiym
筀	gaqe
筜	klqf
簝	ibqk
簠	xuqj
筥	urqf
筶	gsqq
轷	fumr
墦	xker
墣	pres
墈	rkej
塝	nley
鬷	vher
蒈	rpum
堨	jtew
堎	ioee
埼	ydek
埇	jsev
嚚	jafj
埆	yeet
垯	kfek
垎	fjet
坰	useg
坋	xmer
坉	lqem
畬	jrsg
悆	jrsp
弇	jcsk
鹠	igtt
勍	yxyc
伋	udst
伣	ycsg
瘭	nbyj
佖	ndsp
疁	iggv
侹	lxsq
俙	hdsr
俫	izsl
倞	uxsy
偰	htsh
傒	hdsr
僇	irsv
儦	nbsy
儴	hvsy
摛	sily
襚	tapi
襜	skpt
褕	jrps
袯	nnpc
搒	poly
扽	kmlm
厾	krae
扺	eilt
彟	jezu
猄	uxty
鬒	emjj
猯	lwtg
髢	kdjx
猰	jfth
繄	jdmb
匼	rjms
瓻	sirm
髽	eezs
旞	tayq
攽	nkrq
弶	uvzy
廾	ghki
隩	jrxw
鹒	goyt
庱	soye
廆	wiyw
穜	lhqy
穄	udqt
穙	prqs
稑	irqe
稙	eiqj
穟	taqi
亍	suhi
茓	heuo
芠	wmuy
藟	iiug
虷	fkgh
薁	jruw
鹢	jdit
虸	vigx
莙	uquz
茳	uvud
荙	kfuk
盉	fjqg
蒱	prul
祊	xlpy
鄀	anux
矼	glkj
腯	lrae
纼	embz
逴	snap
菼	lkui
鼒	vijg
筤	ilqp
簉	vsqq
鄅	jrwx
耏	zike
芣	xuuk
辿	skgp
糒	nvij
糒	niij
靽	nkji
骦	ddbl
靬	ucjh
荓	pxui
貆	fwre
莝	cnus
蹢	eify
羓	nfix
硿	rhko
竫	uxyt
笯	orqc
衃	pvwk
衃	piwk
羱	jwik
荁	fwue
蟏	hbgu
砆	xukh
鄌	llyx
砠	urkg
硍	rmkz
蔈	nbuj
蚆	nfgx
鞁	nvjc
鞁	nijc
碈	makt
礵	ddkl
豮	xmkj
陑	zixc
盷	lcgt
禒	hcpb
翷	iaiv
胣	siaq
鞳	lfju
齇	efwa
萹	ncup
蓢	ilup
蝲	ifgj
丏	mcja
乸	ofxb
佁	jdsv
佸	fnsq
佽	cisy
侘	sfso
侴	fssx
俍	ivsp
倓	lksi
倴	nwsk
倻	jtsj
偁	sosr
偓	wnsz
偡	eksj
偭	mcsk
偲	cpsg
傃	tush
傉	orsk
僎	ewsz
僔	vqsi
儳	skst
冔	hrgf
冮	glyj
凓	idyj
凘	tiyj
刬	skhs
剅	iyes
剋	rjjs
剕	xias
剟	knvs
劄	efqs
劼	utec
勚	jdjc
匜	jdmx
卬	jvtx
厖	mlkk
叕	envv
叚	ufzz
呇	ydsf
呣	#fb
咉	jvfg
咍	fpfv
咡	zifj
咺	hwfe
哃	lhfg
哢	ihfh
哱	pnfj
唝	ghfj
唵	zkfk
啴	skfi
嗐	fpfo
嘚	kefe
噀	hqfz
噂	vqfi
囷	yqfq
圐	rufg
圙	ijfr
圢	lxej
圫	jreq
圲	yceq
坒	ndme
坥	yreg
坬	geee
坽	ixes
垈	kzse
垍	udew
垏	iuez
垙	gdef
垚	jbee
垞	sfeo
垟	jvei
垵	zkeo
垺	pyer
垾	fkew
垿	hrey
埌	ilep
埗	nrea
埪	rheo
埫	dlef
堃	rqye
堉	jrey
堌	guef
堐	jfek
堧	awek
堲	udze
堼	xoee
堽	gleg
堾	sweh
塅	kwew
塆	wkey
塱	ilpe
墐	uaej
墕	jcej
墘	ycej
墡	dkei
壸	rqej
夐	hstt
奡	zskk
妘	jqch
妧	jwch
姈	ixcs
姞	udce
姱	reck
娀	thcm
娵	urcj
婌	duca
婘	ywci
婞	hxce
婳	fece
婻	okcj
婼	ancu
媄	mvci
媄	mici
媆	awck
媱	jbcr
嫄	jwck
嫕	jdcm
嫚	mkcw
嫭	fuca
嬿	jccj
孅	hccs
宬	sook
寁	vkoz
尨	mlko
屾	dmgg
岊	utxg
岨	urgg
峂	lhgt
峃	heog
峏	zigk
峘	fwge
峛	idgk
峧	ubgy
峱	ostx
崀	ilgp
崁	rkge
崄	hcgs
崡	fkgx
崶	xoge
崿	zjgf
嵁	rkgj
嵚	yagv
嵲	otgw
嶅	zshg
嶟	vqgi
嶲	gags
巇	hdga
帡	pxgi
帨	dagi
幖	nbgj
庤	eiye
庼	yxym
廋	tyyw
廙	jdyg
弨	sszc
弸	poza
忞	wmyp
忺	hcot
恓	hdoj
恔	uboy
悈	utom
悢	ivom
悰	choo
惔	lkoi
惛	fqot
愃	hwoo
愐	mcok
愭	ydoj
慆	lsor
慥	vsoq
慬	uaoj
憕	sot
憙	hdep
戭	jcom
扞	fklh
抃	ncly
拤	yfla
挓	eflo
掞	jcli
揕	emlj
摏	shlh
摴	sull
摽	nblj
擿	eily
敩	hboq
斠	ubjo
旐	esyq
旵	skwg
旿	wuwq
昄	nkwe
昒	fuwt
昤	ixws
昪	ncwv
昳	jdwq
晅	hwwe
晙	uqwv
晢	ejlw
晪	lcwg
晫	enwa
晱	dkwi
暅	hwwo
暕	ucwj
暲	elwy
暵	fkwj
暶	hwwy
暿	hdwe
朓	lbay
朳	nfnr
朸	idnc
杄	ycnq
杕	kdnk
杙	jdnm
杧	mlny
枍	jdnr
枲	hdmf
枹	xunt
柈	pkni
柊	ehnt
柖	dsnc
柷	eunf
栐	jsnp
栒	hqnt
栟	nxni
栻	dinm
桯	jxnf
桲	nnnj
桹	ilnp
梣	smng
梴	sknw
梼	lsnh
梽	eine
棁	enni
棐	xian
棓	nlny
棨	ydpn
棪	jcni
棫	jrnm
棬	uwni
椀	wkno
椑	nvnw
椑	ninw
椓	ennk
椪	poni
椸	jdny
楒	ting
楩	pcns
楪	jtnj
榰	einj
槃	pken
槚	ufnj
槜	vans
槱	jgnj
橞	fanj
櫆	ranw
欂	nnnu
殣	uakj
毌	gwbi
毐	zpeb
氾	xkdb
氿	gadt
汈	kbdz
汋	endt
汫	uxdh
汭	aadg
沄	jqdh
沇	jcdv
沘	nddm
沺	lcdg
泇	ufdc
泙	pxdl
泜	eidt
洑	xuds
洓	tjdj
洘	rsdj
洢	jdds
洣	mddi
洨	hbdy
洭	rddm
洴	pxdi
洸	gddf
洺	mxdt
洿	wudk
浉	didd
浐	skdy
浕	uadz
浛	fkds
浟	jgds
浡	nndj
浬	iddg
浭	godj
浰	iddq
浲	xodt
涄	pxdg
涍	hbdj
涐	zjdq
涘	tidv
涢	jqdf
涴	wkdo
淏	fsdw
淜	poda
淟	lcdg
淯	jrdy
淴	fudt
渟	lxdy
渰	jcds
渼	mvdi
渼	midi
湝	utdm
湣	fqdz
湴	nkdi
溁	jxdu
溇	iydi
溚	kfdu
溞	tsdv
溠	efdi
溦	widg
溵	jade
溹	tndj
滉	fddw
滍	eidg
滘	ubdo
滧	jbdy
滪	jrdv
滫	hgds
漋	ihdx
漖	ubdj
漦	sihk
漴	shdg
漷	fndy
漹	jcdj
漼	cadg
潖	pfdh
潟	hddw
潩	jddg
潵	tfdj
潽	prdi
潾	iadi
澂	sodg
澛	irdt
澪	ixdl
澭	jsdy
澼	pddz
澽	urda
濋	sudn
瀍	skdy
瀔	gude
瀱	uddg
灈	yrdg
炌	rpis
炟	kfiw
炣	rjij
烔	lhig
烝	eoxo
烠	faik
烺	ilip
烻	jciq
焌	uqiv
焞	lqiy
煁	smij
煃	raik
煋	hxiw
煟	wiig
熛	nbij
熥	loiv
熻	hdis
燊	dmin
燋	ubis
燚	jdii
爇	anue
爔	hdii
爟	gwiu
牚	sofm
牥	xlqy
牻	mlqk
犇	nwqq
犨	sywq
狉	pdtk
猺	jbtr
玃	uetg
玒	fhhj
玓	kdht
玙	jrhm
玞	xuhh
玤	nlhh
玶	pxhl
玿	dshc
珇	vuhg
珋	ight
珒	uahz
珕	idhc
珖	gdhf
珛	hghk
珝	hrhv
珢	jahz
珦	hvhw
珫	shhy
珵	sohf
珹	sohk
珽	lxhq
琀	fkhs
琇	hghq
琈	xuhr
琎	uahh
琔	kcho
琟	wihs
琡	duha
琲	nvha
琲	niha
瑀	jrhw
瑃	sqhh
瑆	hxhw
瑑	ewhb
瑓	ichj
瑖	kwhw
瑧	emhh
瑬	igdh
瑳	cnhi
璒	koht
璥	uxhu
璪	vshf
璬	ubhw
璱	tjhh
瓖	hvhy
甡	dmqq
甦	tujq
甪	irei
畖	wfge
畤	eige
畯	uqgv
疢	smyi
疭	vhys
癗	iiyl
癿	ytwa
皕	ndkk
皛	hbww
皞	fsww
皦	ubww
皭	ubwr
砵	nnkj
膙	uvaz
苉	pdum
茋	eiut
萣	kxuo
萳	okuj
蔃	yvuz
薸	pbud
蚲	pxgl
蛃	nxgj
觃	jcgx
陎	duxq
馞	nnqj
骉	nbbb
鹲	mout
齉	olwj
矇	mogu
囧	usgr
慓	pboj
揾	wmlw
琍	idhq
檵	udnb
枒	jfnm
蠧	kreg
俬	tisq
粬	yrig
歔	hrat
誌	eiye
砢	inkj
頔	kdgk
娭	hdcv
彿	xuez
嘢	jtfg
傢	ufso
冇	mskg
碁	ydjk
袴	rupk
毑	utbx
沢	vjdz
嬅	fecu
觍	lcgg
乂	jdro
㧐	thlv
㧟	rrld
䏝	sqah
𬉼	zyim
㤘	suot
𠳐	nlfh
䥽	pnvc
䁖	iygi
𥻗	sfin
䦃	envu
㸆	rsiq
彳	siei
𠙶	zyxx
𬣙	hrph
𨙸	ydjx
𬇕	wkdk
䜣	hdpe
𬣞	eupo
𬘓	hqbw
𫭟	zyem
𫭢	iqes
㧑	wilc
𫇭	wiuc
𫐄	jemk
㕮	xufr
𫵷	idgk
㑇	eyst
𣲘	wudh
𣲗	widh
𬇙	pvdg
𬇙	pidg
㳇	xudr
𬣡	ucph
𫸩	ryzm
䢺	suxx
𨚕	ncvx
𫘜	wmby
𬘘	kkbp
𫘝	uebz
䢼	ghjx
𦭜	viuf
㭎	glng
𬨂	ydmt
𬀩	wiwh
𬀪	hcwg
㟃	tigz
𬬩	jdvm
㑊	jdsy
𫍣	lhpg
𬣳	fmpz
𬩽	hqzx
𬮿	gpxg
𬯀	udxy
𫰛	hxcv
𬳵	pdbk
𬳶	usbg
䌹	usbg
𫠊	hwby
㛃	uthc
𬍛	idht
鿍	glet
𬜬	mkuu
𦰡	ofuz
㭕	yrne
䴓	dijt
䶮	jckh
𪾢	hcgg
𪨰	yrgg
𫓧	xuvh
𬬮	slvq
𬬱	uave
𬬭	iqvs
䏡	diah
𦙶	guaj
㶲	jsit
㳚	jrdk
㳘	shdy
𬘡	jabg
𬳽	dmbq
𬘩	lxbq
𫄧	hcbw
𪟝	udhc
𬍤	hqhz
𫭼	iseu
𬜯	ivuj
䓖	ysuo
𬂩	ufnl
𫠆	rajk
𨐈	gdmf
𬌗	fjms
𫑡	mofx
𪨶	djgm
𬬸	duvn
𬬻	irva
𬬹	fwvg
𬬿	esvc
𬭁	mrvb
𫢸	kksi
𫗧	tutj
𬊈	hqiz
𬒈	yeok
𨺙	odxw
㛚	lhcv
𬳿	lrbs
𫄨	sibr
𬘫	fwvo
䂮	ijhk
𫮃	dkei
㙍	knev
䓫	uduj
䓬	esua
䓨	jxuq
䓛	xuuz
鿎	lfkk
䴕	itkt
㫰	ilwp
𬱖	kdgk
𬟽	khgm
䎃	akgv
𫓯	udve
𫟹	fhvj
𫟼	kfvk
㿠	fdwf
䝙	surm
䏲	ktai
𠅤	hdyg
䴔	ubyt
𬇹	gndf
𬍡	kldh
㥄	ixoe
𬤇	japj
𫍯	hcpk
𬤊	dipw
𫍲	hbpw
𬯎	laxg
𬘬	ycbh
𬘭	smbn
𬴂	xiba
𫘦	lsbt
𫟅	ivby
𬘯	eqby
𫘧	irbz
㙘	jbej
𪣻	iyei
𡎚	pcep
𬃊	eine
𬷕	nrjt
𫐐	odmw
𬹼	htas
𧿹	mrfb
𫶇	ktgj
𫖮	jdgk
𥖄	hcki
𬭊	krvn
𨱇	ygvj
𫓶	uwvf
𬭎	fhvo
𫖯	xuyk
䐃	usaf
𬱟	witk
𫛭	rdtt
㺄	jrts
𫷷	hayv
𬮱	jauj
𬊤	skii
𣸣	xmdj
㴔	tjdt
㛹	pccs
𬴃	fnbh
𫘨	ldbw
䴖	uxht
𤧛	kdhy
𬪩	ohjp
𬒔	goka
䃅	kdki
𬨎	jgmi
𫐓	aymv
䣘	llfx
𫫇	zjfj
㬊	fwwr
𫓹	udvj
𬭚	sqvy
𬭛	nnvd
䅟	ckqv
𬕂	ihqj
䲟	jatt
𬶋	urtt
𬶍	lnto
𦝼	iuai
𫔶	otuw
𫌀	udph
𫖳	jqzk
𫘪	jwbk
𫘬	hdbr
𫞩	mwhu
𡐓	rley
𪤗	ibev
𣗋	klnf
𬸘	jcmt
䃎	efkk
𬒗	ikkw
𥔲	zjkf
𫚖	ciat
䴗	urgt
㬎	hcwb
𨱏	kfvu
𬭤	fyvs
㙦	htse
𫚕	ditw
𬶐	esty
𬶏	witt
𩽾	zkto
𬸚	jett
㽏	gkdj
㮾	ilpn
𬤝	fapj
𬙂	jcbo
㻬	lrhl
䗖	kdgj
㠇	uggy
𬭩	wovr
䴘	ldet
𩾃	mctt
㵐	uedk
𬸣	hcot
𫍽	hwpg
𬴊	iabi
𬞟	paua
𥕢	cskj
𫟦	tami
𬺈	jdak
𫠜	odaw
㬚	sjwy
䗛	hggs
㠓	mogu
𪩘	jcgj
𬭬	wivh
𨱑	fdvj
𬭯	ptvi
𫗴	ekty
𬸦	enyt
𫄷	jdby
𤩽	fwhj
㘎	fkfu
𬭳	hdve
𬭶	fivg
𫔍	xkvr
𬭸	iavi
𨱔	vqvi
𬭼	tavi
𫔎	uevv
𬸪	xkrt
䲠	sqth
𬶟	iftj
𬶠	ictj
䗪	ejyg
𬶨	udzt
𦈡	hrbl
𫄸	hqbq
𬟁	jduj
𥖨	vskf
䗴	lxgq
䲢	loai
𦒍	lhyv
䎖	voiv
䴙	pdzy
𬙊	mnbg
㰀	idnq
𬶭	udtt
𩾌	rlty
𨟠	ywgx
𬶮	hdte
𨭉	nkyv
㸌	fnil
𬙋	alby
𤫉	hthi
𬺓	suan
𫚭	ittb
地	keex
觉	ubog
着	esig
了	ibxi
都	krjx
曾	voiw
行	fleh
得	kiew
似	disv
调	kbpt
着	enig
露	iylf
朝	esja
校	ubny
还	fwkp
角	uett
薄	nsud
便	pcsj
藏	vluk
弹	kkzi
仔	visx
劲	uxvc
参	dmve
血	htwe
熟	dyyo
乐	jeto
朴	pbnf
纤	hcbq
仇	ygst
膀	play
传	ewsh
的	kdwt
什	disj
率	dryb
辟	ndzy
塞	tjoe
陆	igxh
咳	rjfy
大	kzko
俩	ivsj
宿	hgos
卡	yfao
削	hefs
颤	ekyk
称	smqt
粘	ekia
弄	ihhk
乾	gkjq
模	mrnu
吁	hrfh
柏	nnnw
佛	xusz
蔓	mkuw
厦	dfkk
脯	xuaj
扎	vfla
藉	uduh
差	spij
落	ifud
彷	xley
茄	ytuc
咽	jtff
盛	sokg
伺	cisz
匙	siwt
抹	mflh
没	mndt
奇	udke
喔	znfz
系	udtd
刹	sfrs
说	dapi
嚼	uefr
咖	rffc
畜	hryg
泊	pndw
脉	mnap
圈	uwfi
栖	hdnj
解	httc
辗	ocmz
落	isud
拗	oglb
裳	slfy
勒	iijc
单	dkig
牟	mrvq
堡	prse
嚓	cffo
爪	eseo
隽	uwsc
降	hvxt
巷	fljz
澹	kkdt
折	djle
迫	pzwp
更	uxjo
桔	utne
蚌	nogh
差	ciij
槟	nxno
色	dptx
尾	jdzq
咯	inft
攒	cwlq
艾	jdur
绰	ssba
剥	nszs
和	fnqf
莘	dmuy
偻	iusi
澄	kodv
若	ajuk
石	kkkf
腌	jcak
壳	ybet
会	rrsh
峒	lhgg
伽	ytsc
伽	ufsc
咯	gjft
邪	jtmx
单	skig
曝	prww
屏	nxzi
查	efnw
啁	esft
囤	kqfm
貉	fsrt
奘	edxk
六	iryr
乘	doqa
卒	cuys
莎	tnud
尺	sjzo
芥	gpus
阿	zjxe
俟	ydsv
溺	obdz
拓	lflk
螫	dieg
提	kdlw
莞	wkuo
钿	kcvg
喳	sffn
柜	urnm
识	eipf
侗	lhsg
褚	eupj
荥	hxud
佃	lcsg
咀	vafg
秘	ndqp
繇	eyrt
繇	jgrt
浚	hqdv
嘲	esfj
吓	fjfj
玟	mahy
宛	jwot
冒	mngg
荑	ldum
度	knyv
朴	pnnf
区	zymr
蓼	iruv
诘	udpe
呙	gefg
镐	fsvy
挲	dfdl
幢	sdgy
纥	gjbq
偈	utsw
捋	inlr
属	euzw
暴	prwj
衰	cayg
掸	dkli
娜	oncz
省	hxdg
颉	htek
缉	ydbf
糜	mvyi
糜	miyi
纶	gwbs
柞	efnq
禅	dkpi
刨	nsts
浅	ucdh
笮	vjqq
龟	uqtg
侧	epsg
给	udbs
合	gjsf
瀑	nsdw
褪	lqpz
扁	pcpg
埋	mkeg
盖	fjig
盖	gjig
扛	gllj
覃	lkjw
炅	gawi
红	ghbj
亟	ydxe
万	mnmu
丁	eoji
氏	eita
贲	ndjg
县	hwgv
呗	nzfg
契	hthk
契	ythk
翟	kdvs
许	fupq
吽	fyfq
繁	pnqb
贾	gujg
椎	sans
炮	nsit
洗	hcdq
埔	nrej
摩	mfyl
噱	uefa
歙	hdst
拾	djls
雀	ybds
铛	sovf
疋	pdxo
强	uvzf
摄	otlj
桁	flne
车	urmi
约	jbbt
蛤	gjgs
咋	effq
窨	hqoy
磅	plky
核	funy
砬	ifky
陂	pnxc
剡	dkis
殷	jcet
龈	rmaz
缪	mrbv
缪	mybv
价	utss
期	udja
尿	tazd
缴	enbw
芫	jwuh
伯	nfsw
屯	eqma
杉	dfne
楷	utnm
蛇	jdgo
读	kvpj
读	kypj
夯	nwkc
参	tkve
参	cmve
汤	dldc
阏	zjuy
荠	uduy
芴	fuut
阇	djuk
靓	uxhg
枸	urnt
恶	wujp
臭	hgwk
坻	siet
菑	vpug
砩	xikz
帑	orcg
徵	eieg
拽	jtlg
芘	ndum
匮	gamg
铊	lnvo
鬲	gjef
芾	xuuj
乜	otba
咋	vjfq
钯	pfvx
撮	vnlw
袷	utps
鞔	mwjt
綮	ydpb
楯	dqne
莩	xuur
淠	pvdg
淠	pidg
慊	ytoi
嚄	fnfu
伭	hwsy
砉	fehk
艽	ygut
拶	vklb
缲	ybbf
埏	dkew
甾	vibg
铫	kbvr
裼	ldpw
杻	synx
亹	mwyg
熜	vhiw
瘥	spyi
嗨	fpfd
厂	zkku
厂	fkku
卜	nnfo
大	lzko
么	mnto
么	mfto
么	jbto
广	zkyu
女	auce
不	xyko
内	ofgo
从	vhss
且	urge
叶	htfj
叨	lsfc
乐	jbto
乐	isto
句	gytf
冯	pxyb
宁	euoj
夹	gflo
邪	jfmx
邪	hrmx
岂	rpgz
朱	duqo
休	hrsn
份	nasr
肋	ieac
齐	udyw
齐	viyw
齐	epyw
羊	hvii
孙	hqxd
妃	pvcz
妃	picz
她	utcx
戏	fuvm
抢	sols
吾	jrjf
否	pdkf
助	sugc
员	jqfg
佛	ndsz
佛	nnsz
龟	ygtg
甸	lctg
甸	dotg
兑	aaif
兑	jeif
弟	ldiz
拓	eilk
拘	gylt
拌	pkli
拂	ndlz
苛	fjue
苹	poul
枝	ydnj
转	ermh
些	tnah
呵	rjfe
和	fuqf
侧	vjsg
疟	jbym
疙	jdyq
净	soyt
券	hwic
泄	jddj
泌	nddp
泽	didv
详	jvpi
毒	kzhb
挎	rulk
挟	ufll
南	ofjg
栅	efnt
栅	dfnt
栅	cjnt
勃	nvjc
勃	nijc
砌	ytkm
思	tpgp
适	rnqp
种	shqg
俏	hbsf
信	dmsy
追	kawp
食	jdsp
兹	ciib
洒	hddj
说	jepi
姥	mrcj
莫	mruw
蚣	ehgr
罢	pdge
倘	slsf
射	jtwj
射	jdwj
烙	init
涌	jsdv
家	utok
被	pdpc
调	eypt
能	ozvt
难	onvs
捻	otls
掺	hclv
掺	cklv
掺	dklv
著	ejuj
梢	tsnf
副	pdes
硕	dikk
唬	hffa
崭	skgm
祭	epth
渠	urdn
淌	sldf
淳	eqdy
隋	knxk
堕	faxe
综	vobo
琢	vnhk
趋	cuet
揭	ydlw
彭	nlee
揣	lwlg
揣	ealg
棱	ixne
棍	fqnw
景	jxwy
喝	jtfw
堡	nrse
奥	jrwk
港	uvdj
愉	lvos
愉	lyos
粥	jrzi
填	emej
碌	igkz
频	naak
跳	lsfr
蛾	jdgq
疑	odtv
趣	cuej
瞒	mwgu
嘿	mnfg
蟆	mngu
豁	feor
簿	nnqd
疆	yvze
仡	gjsq
圩	hreh
伎	ydsj
伧	smss
圻	ydee
苣	yrum
忒	lamp
旰	fkwh
呒	#fh
吡	ndfm
町	lxgj
吽	zyfq
吲	dmfz
佚	ktsq
佝	ryst
亨	poyf
汩	jrdw
汶	mwdy
忾	hdoq
忪	ehor
诒	kzpv
陂	nvxc
陂	nixc
纰	ndbm
玢	xmhr
苴	sfug
苕	dsuc
枞	vhns
枋	nxny
黾	mcfg
黾	mofg
呱	gufe
呣	myfb
沓	kfdw
竺	krqh
郄	hdrx
䏝	ewah
肫	sqam
郇	fwtx
疠	izym
泷	dddk
泺	pndt
怍	efoq
㤘	cuot
㤘	eyot
宓	xuop
祇	eipt
拮	ufle
挝	wnlj
垌	kheg
荨	ycuz
剋	#js
柢	sint
栎	jent
柈	nkni
柁	lnno
郦	eiex
禺	zygo
呲	cifa
哕	jefg
咯	rfft
哏	fmfz
峙	dige
峤	ybgq
俞	dusa
朐	yrat
朐	hrat
饹	gjvt
浍	rrds
恓	ydoj
恓	hroj
姣	hbcy
矜	yavs
矜	gwvs
珲	fahp
耆	dijw
垸	fweo
莨	ilup
桡	osnm
栝	lcnq
桧	fans
栟	nwni
晟	sowk
眙	jdgv
趵	nnft
俶	ldsa
恁	oasp
倭	wisq
皋	fswk
悝	raog
堋	noea
菀	wkuo
硌	inkt
眭	tage
喏	ajfu
啉	ikfn
啁	lbft
啐	ydfy
啜	srfv
崚	ixge
铣	hdvq
铤	kxvq
铪	rjvs
铫	lbvr
傀	gasw
渎	kvdj
渎	kydj
淖	osda
淖	snda
渑	mcdf
惮	kfoi
窕	jbor
谌	dmpj
袷	yfps
隗	raxw
欸	zivt
趄	ureg
颉	ufek
棹	enna
棣	kznz
棣	ldnz
睄	ybgf
睄	hbgf
喋	effj
嗒	lffu
跞	inft
崴	wigk
犍	ycqz
颌	gjsk
焯	enia
湮	jadj
湫	ygdq
韫	wmhw
楂	sfnn
睢	fags
睥	pdgw
嗄	dffk
嗌	zpfi
筠	uqqe
貉	mnrt
溱	yadh
裨	pdpw
斡	gwjs
碣	jfkw
臧	clkm
嘞	iefj
嘘	difa
嘚	kife
鹘	gugt
箐	uxqh
箢	jwqo
僮	edsy
鲑	htte
麽	mnyt
麽	mfyt
糁	dmiv
潢	gddj
漯	lfdg
骠	nbbj
缪	ibbv
槭	tjnk
镉	gjve
澍	eude
鞘	dsjf
蟒	mogu
圜	jwfg
麇	uqyq
膻	dkay
鳃	hdtg
濞	nddw
濯	esdv
擘	nzzl
隳	knxs
瞿	urgs
鳜	uetk
戆	edyp
毌	wkbi
氿	ugdt
圫	eqeq
吖	jffi
犴	fkth
汋	yedt
䜣	hape
䜣	jape
孖	mfxx
玚	slhc
坉	kqem
坋	nwer
杕	knnk
尨	ihko
尨	moko
尨	plko
呙	wpfg
呙	fjfg
呙	wnfg
呙	wffg
佁	sisv
忳	eqom
忳	kqom
妧	wkch
玱	clhs
苧	euuo
矼	yvkj
矼	rhkj
匼	yfms
佴	ozsj
隹	casy
隹	wisy
忞	mayp
於	wuys
泙	podl
祊	nopy
叕	jdvv
叕	idvv
叕	uevv
珇	urhg
玹	hchy
𦰡	onuz
枹	nsnt
耏	ozke
奓	sikt
奓	efkt
盷	hcgt
昳	ktwq
咥	ktfm
朏	ruax
洓	yddj
洓	vidj
恔	hboy
祕	ndpp
姱	fuck
姤	krce
姶	jfcs
𫄧	jcbw
珢	rmhz
垺	xuer
埆	ueet
莶	icus
梴	jcnw
唝	fhfj
哱	nffj
哱	nnfj
蚄	nlgy
帱	ksgh
倞	ivsy
竘	yryt
烔	khig
浟	kdds
浲	fhdt
悈	rjom
𬒈	fuok
隺	fjpe
哿	ufce
埫	shef
掞	dkli
䓫	yduj
菍	amus
䓛	guuz
䓛	yruz
梼	synh
梼	ksnh
桯	lxnf
梌	sfns
硊	gakt
硍	hckz
硍	gqkz
硍	jakz
啫	difk
畤	syge
畤	dige
啴	lkfi
啴	lnfi
崒	cagy
偲	tisg
偁	smsr
悆	dusp
焆	jtif
焌	yriv
淜	pxda
湴	pkdi
涴	wndo
涴	jwdo
惛	mwot
惔	kkoi
惙	saov
隃	jbxs
隃	duxs
婼	sncu
婫	fqcw
婤	syct
婘	uwci
𬘭	iabn
絜	uthb
琟	jrhs
堨	zjew
堨	zpew
蒉	rrug
棽	dmns
椆	eynt
椆	kbnt
棓	pyny
棓	nvny
棓	niny
棬	ywni
龂	rmae
嵁	ekgj
圌	safg
𫓶	hwvf
稌	duqs
傕	uesp
畬	djsg
猰	ufth
猰	ytth
廆	gayw
廆	fayw
粢	ciyi
遆	kdyp
欻	#it
溚	lfdu
㴔	jddt
湣	madz
敩	heoq
媆	owck
媂	ldcy
矞	jrvg
矞	hrvg
缊	wmbw
搒	nlly
椹	dmnj
楪	ktnj
榅	jqnw
歅	jcjt
碏	hdkj
觜	viat
暕	ikwj
鲌	nntw
觟	htte
漷	rndy
禔	ldpw
缞	caby
缞	taby
耤	uthj
瑱	emhj
榑	nnnj
疐	kdjg
夐	hwtt
廑	yayj
瘕	hfyz
熇	hbiy
漴	eddg
漻	igdv
慬	yaoj
隩	zsxw
槱	ssnj
磏	ycki
嶲	hdgs
嶲	uwgs
觭	ydtk
潵	tkdj
憕	kot
憕	eot
薳	jwue
橦	sdny
嶦	dkgt
燋	ybis
燋	ueis
燋	enis
濩	fndu
擿	ldly
檞	htnt
穜	ehqy
魋	saws
嬬	oycl
嬥	kbcv
釐	hdhk
蹢	kdfy
镮	hwvg
酂	cnqx
馧	wnqw
鬷	voer
儴	alsy
孅	yccs
疋	jfxo
囝	okfx
沲	kndq
揲	djlj
綄	fwbo
缏	ncbs
趹	gafz
拚	pklv
楱	vynh
丌	ydki
囗	gnfe
糸	tibd
凵	rkxi
砢	rjkj
娭	zpcv
